AAAACTTTAAAATAACCAAA -> AAACTTTAAAATAACCAAAT
AAAATAACCAAATTAAGTCA -> AAATAACCAAATTAAGTCAT
AAACACGTGCCTGGACGAGG -> AACACGTGCCTGGACGAGGG
AAACGAATGCACAGAACAGG -> AACGAATGCACAGAACAGGC
AAACTGAAGCACTCCCAACA -> AACTGAAGCACTCCCAACAT
AAACTTTAAAATAACCAAAT -> AACTTTAAAATAACCAAATT
AAAGCAATATGAATCCTTAA -> AAGCAATATGAATCCTTAAT
AAAGCATGCGGGCGTGGATG -> AAGCATGCGGGCGTGGATGT
AAAGGGTCATTGATATAAAA -> AAGGGTCATTGATATAAAAC
AAATAACCAAATTAAGTCAT -> AATAACCAAATTAAGTCATT
AAATATACGTTTCTAGTCCG -> AATATACGTTTCTAGTCCGG
AAATTAAGTCATTCTGTTCT -> AATTAAGTCATTCTGTTCTC
AAATTATAGGAGGTATTCGA -> AATTATAGGAGGTATTCGAG
AACAACGGTGGAGAAACTGA -> ACAACGGTGGAGAAACTGAA
AACACATAGCCGAAGGTACG -> ACACATAGCCGAAGGTACGT
AACACGTGCCTGGACGAGGG -> ACACGTGCCTGGACGAGGGT
AACAGGCTCAAGGAATATAT -> ACAGGCTCAAGGAATATATA
AACATGTTTTCATAGAGTGT -> ACATGTTTTCATAGAGTGTT
AACCAAATTAAGTCATTCTG -> ACCAAATTAAGTCATTCTGT
AACCCTCAGTCGATTAGTCC -> ACCCTCAGTCGATTAGTCCA
AACGAATGCACAGAACAGGC -> ACGAATGCACAGAACAGGCT
AACGCGCTGATCCGGGCCGT -> ACGCGCTGATCCGGGCCGTT
AACGGCAAATATACGTTTCT -> ACGGCAAATATACGTTTCTA
AACGGTGGAGAAACTGAAGC -> ACGGTGGAGAAACTGAAGCA
AACGTAGCCTATATTGGCTG -> ACGTAGCCTATATTGGCTGC
AACGTGTCCCGGGCGAGGCA -> ACGTGTCCCGGGCGAGGCAG
AACTCCAACAACGGTGGAGA -> ACTCCAACAACGGTGGAGAA
AACTGAAGCACTCCCAACAT -> ACTGAAGCACTCCCAACATG
AACTGCGTGTTGGGCAGTCA -> ACTGCGTGTTGGGCAGTCAC
AACTTTAAAATAACCAAATT -> ACTTTAAAATAACCAAATTA
AAGAGCTGAAAGCAATATGA -> AGAGCTGAAAGCAATATGAA
AAGAGGATGGTTCGTCGGTA -> AGAGGATGGTTCGTCGGTAT
AAGATCGTAACGCGCTGATC -> AGATCGTAACGCGCTGATCC
AAGCAATATGAATCCTTAAT -> AGCAATATGAATCCTTAATT
AAGCACTCCCAACATGTTTT -> AGCACTCCCAACATGTTTTC
AAGCATGCGGGCGTGGATGT -> AGCATGCGGGCGTGGATGTG
AAGGAATATATAGGTCCAGA -> AGGAATATATAGGTCCAGAC
AAGGGACATGGAGTACCTAC -> AGGGACATGGAGTACCTACC
AAGGGTCATTGATATAAAAC -> AGGGTCATTGATATAAAACT
AAGGTACGTACGATTATTAC -> AGGTACGTACGATTATTACC
AAGTCATTCTGTTCTCTCTA -> AGTCATTCTGTTCTCTCTAA
AATAACCAAATTAAGTCATT -> ATAACCAAATTAAGTCATTC
AATATACGTTTCTAGTCCGG -> ATATACGTTTCTAGTCCGGC
AATATATAGGTCCAGACAAG -> ATATATAGGTCCAGACAAGA
AATATCGCGGAGGTGATACT -> ATATCGCGGAGGTGATACTG
AATATGAATCCTTAATTGTG -> ATATGAATCCTTAATTGTGC
AATATTCATTTCTTGATTAG -> ATATTCATTTCTTGATTAGC
AATCCTTAATTGTGCTGCAG -> ATCCTTAATTGTGCTGCAGA
AATGCACAGAACAGGCTCAA -> ATGCACAGAACAGGCTCAAG
AATGCCGTCCCGTGCCAATG -> ATGCCGTCCCGTGCCAATGT
AATGCGAGCCTATCCAGCGT -> ATGCGAGCCTATCCAGCGTC
AATGTGATTCGAGTCACATC -> ATGTGATTCGAGTCACATCT
AATTAAGTCATTCTGTTCTC -> ATTAAGTCATTCTGTTCTCT
AATTATAGGAGGTATTCGAG -> ATTATAGGAGGTATTCGAGA
AATTCGCCAATTGCGGGTCA -> ATTCGCCAATTGCGGGTCAG
AATTGCGGGTCAGTTAGTTC -> ATTGCGGGTCAGTTAGTTCA
AATTGTGCTGCAGATAGACT -> ATTGTGCTGCAGATAGACTG
ACAACGGTGGAGAAACTGAA -> CAACGGTGGAGAAACTGAAG
ACAAGAGGATGGTTCGTCGG -> CAAGAGGATGGTTCGTCGGT
ACAATATCGCGGAGGTGATA -> CAATATCGCGGAGGTGATAC
ACACATAGCCGAAGGTACGT -> CACATAGCCGAAGGTACGTA
ACACGCGAGAGCTGGCGGCC -> CACGCGAGAGCTGGCGGCCT
ACACGTGCCTGGACGAGGGT -> CACGTGCCTGGACGAGGGTC
ACAGAACAGGCTCAAGGAAT -> CAGAACAGGCTCAAGGAATA
ACAGGCTCAAGGAATATATA -> CAGGCTCAAGGAATATATAG
ACATACCCTTATGAACGTAG -> CATACCCTTATGAACGTAGC
ACATAGCCGAAGGTACGTAC -> CATAGCCGAAGGTACGTACG
ACATCCCGTAGTTCTGGTGT -> CATCCCGTAGTTCTGGTGTC
ACATCTCTGCGTTTCTGGGT -> CATCTCTGCGTTTCTGGGTA
ACATGGAGTACCTACCGCAA -> CATGGAGTACCTACCGCAAA
ACATGTTTTCATAGAGTGTT -> CATGTTTTCATAGAGTGTTC
ACCAAATTAAGTCATTCTGT -> CCAAATTAAGTCATTCTGTT
ACCACACGCGAGAGCTGGCG -> CCACACGCGAGAGCTGGCGG
ACCACGGAGGCGGACCGGAA -> CCACGGAGGCGGACCGGAAG
ACCAGTGGCTTGTCGTTACC -> CCAGTGGCTTGTCGTTACCC
ACCCAACTGCGTGTTGGGCA -> CCCAACTGCGTGTTGGGCAG
ACCCTCAGTCGATTAGTCCA -> CCCTCAGTCGATTAGTCCAC
ACCCTTATGAACGTAGCCTA -> CCCTTATGAACGTAGCCTAT
ACCGCAAACACGTGCCTGGA -> CCGCAAACACGTGCCTGGAC
ACCGCTAGGGGTTCTATTGG -> CCGCTAGGGGTTCTATTGGA
ACCGGAAGATCGTAACGCGC -> CCGGAAGATCGTAACGCGCT
ACCGTAGGCGAGTGCCTGTC -> CCGTAGGCGAGTGCCTGTCG
ACCTACCGCAAACACGTGCC -> CCTACCGCAAACACGTGCCT
ACCTCCTAAAGGGTCATTGA -> CCTCCTAAAGGGTCATTGAT
ACCTGGATTGTAACGGCAAA -> CCTGGATTGTAACGGCAAAT
ACCTGGCTGGCCCACGATGT -> CCTGGCTGGCCCACGATGTT
ACGAATGCACAGAACAGGCT -> CGAATGCACAGAACAGGCTC
ACGAGGGTCCCAAACGAATG -> CGAGGGTCCCAAACGAATGC
ACGATGTTCCCTTGTTACAT -> CGATGTTCCCTTGTTACATC
ACGATTATTACCACACGCGA -> CGATTATTACCACACGCGAG
ACGCCACAATATCGCGGAGG -> CGCCACAATATCGCGGAGGT
ACGCGAGAGCTGGCGGCCTT -> CGCGAGAGCTGGCGGCCTTG
ACGCGCTGATCCGGGCCGTT -> CGCGCTGATCCGGGCCGTTT
ACGGAGGCGGACCGGAAGAT -> CGGAGGCGGACCGGAAGATC
ACGGCAAATATACGTTTCTA -> CGGCAAATATACGTTTCTAG
ACGGTACGGTCAATTCGCCA -> CGGTACGGTCAATTCGCCAA
ACGGTCAATTCGCCAATTGC -> CGGTCAATTCGCCAATTGCG
ACGGTGGAGAAACTGAAGCA -> CGGTGGAGAAACTGAAGCAC
ACGTAACGTGTCCCGGGCGA -> CGTAACGTGTCCCGGGCGAG
ACGTACGATTATTACCACAC -> CGTACGATTATTACCACACG
ACGTAGCCTATATTGGCTGC -> CGTAGCCTATATTGGCTGCG
ACGTGCCTGGACGAGGGTCC -> CGTGCCTGGACGAGGGTCCC
ACGTGTCCCGGGCGAGGCAG -> CGTGTCCCGGGCGAGGCAGC
ACGTTTCTAGTCCGGCCCGG -> CGTTTCTAGTCCGGCCCGGC
ACTCCAACAACGGTGGAGAA -> CTCCAACAACGGTGGAGAAA
ACTCCCAACATGTTTTCATA -> CTCCCAACATGTTTTCATAG
ACTGAAATTATAGGAGGTAT -> CTGAAATTATAGGAGGTATT
ACTGAAGCACTCCCAACATG -> CTGAAGCACTCCCAACATGT
ACTGCGTGTTGGGCAGTCAC -> CTGCGTGTTGGGCAGTCACC
ACTGGATTTACCTGGCTGGC -> CTGGATTTACCTGGCTGGCC
ACTGTATCCGCTGGCAAGGG -> CTGTATCCGCTGGCAAGGGA
ACTTGGTACCTCCTAAAGGG -> CTTGGTACCTCCTAAAGGGT
ACTTTAAAATAACCAAATTA -> CTTTAAAATAACCAAATTAA
AGAAACTGAAGCACTCCCAA -> GAAACTGAAGCACTCCCAAC
AGAACACATAGCCGAAGGTA -> GAACACATAGCCGAAGGTAC
AGAACAGGCTCAAGGAATAT -> GAACAGGCTCAAGGAATATA
AGACAAGAGGATGGTTCGTC -> GACAAGAGGATGGTTCGTCG
AGACCGCTAGGGGTTCTATT -> GACCGCTAGGGGTTCTATTG
AGACTGAAATTATAGGAGGT -> GACTGAAATTATAGGAGGTA
AGAGCTGAAAGCAATATGAA -> GAGCTGAAAGCAATATGAAT
AGAGCTGGCGGCCTTGTCTC -> GAGCTGGCGGCCTTGTCTCA
AGAGGAGCAACCCTCAGTCG -> GAGGAGCAACCCTCAGTCGA
AGAGGATGGTTCGTCGGTAT -> GAGGATGGTTCGTCGGTATA
AGAGTGTTCAGGTGCGATGG -> GAGTGTTCAGGTGCGATGGG
AGATAGACTGAAATTATAGG -> GATAGACTGAAATTATAGGA
AGATCGTAACGCGCTGATCC -> GATCGTAACGCGCTGATCCG
AGCAACCCTCAGTCGATTAG -> GCAACCCTCAGTCGATTAGT
AGCAATATGAATCCTTAATT -> GCAATATGAATCCTTAATTG
AGCACTCCCAACATGTTTTC -> GCACTCCCAACATGTTTTCA
AGCATGCGGGCGTGGATGTG -> GCATGCGGGCGTGGATGTGC
AGCCGAAGGTACGTACGATT -> GCCGAAGGTACGTACGATTA
AGCCTATATTGGCTGCGTGA -> GCCTATATTGGCTGCGTGAG
AGCCTATCCAGCGTCGTTCC -> GCCTATCCAGCGTCGTTCCG
AGCCTCACCTGGATTGTAAC -> GCCTCACCTGGATTGTAACG
AGCGTCGTTCCGGTCATACC -> GCGTCGTTCCGGTCATACCA
AGCTGAAAGCAATATGAATC -> GCTGAAAGCAATATGAATCC
AGCTGGCCACCGTAGGCGAG -> GCTGGCCACCGTAGGCGAGT
AGCTGGCGGCCTTGTCTCAT -> GCTGGCGGCCTTGTCTCATT
AGCTTGCTTGACGCCACAAT -> GCTTGCTTGACGCCACAATA
AGGAATATATAGGTCCAGAC -> GGAATATATAGGTCCAGACA
AGGAGCAACCCTCAGTCGAT -> GGAGCAACCCTCAGTCGATT
AGGAGGTATTCGAGAGGAGC -> GGAGGTATTCGAGAGGAGCA
AGGATGGTTCGTCGGTATAT -> GGATGGTTCGTCGGTATATT
AGGCAGCTTGCTTGACGCCA -> GGCAGCTTGCTTGACGCCAC
AGGCGAGTGCCTGTCGTCCA -> GGCGAGTGCCTGTCGTCCAA
AGGCGGACCGGAAGATCGTA -> GGCGGACCGGAAGATCGTAA
AGGCTCAAGGAATATATAGG -> GGCTCAAGGAATATATAGGT
AGGGACATGGAGTACCTACC -> GGGACATGGAGTACCTACCG
AGGGATCACATACCCTTATG -> GGGATCACATACCCTTATGA
AGGGGTTCTATTGGACGTAA -> GGGGTTCTATTGGACGTAAC
AGGGTCATTGATATAAAACT -> GGGTCATTGATATAAAACTT
AGGGTCCCAAACGAATGCAC -> GGGTCCCAAACGAATGCACA
AGGTACGTACGATTATTACC -> GGTACGTACGATTATTACCA
AGGTATTCGAGAGGAGCAAC -> GGTATTCGAGAGGAGCAACC
AGGTCCAGACAAGAGGATGG -> GGTCCAGACAAGAGGATGGT
AGGTGATACTGGATTTACCT -> GGTGATACTGGATTTACCTG
AGGTGCGATGGGCCGGGTTC -> GGTGCGATGGGCCGGGTTCT
AGTACCTACCGCAAACACGT -> GTACCTACCGCAAACACGTG
AGTCACATCTCTGCGTTTCT -> GTCACATCTCTGCGTTTCTG
AGTCACCACGGAGGCGGACC -> GTCACCACGGAGGCGGACCG
AGTCATTCTGTTCTCTCTAA -> GTCATTCTGTTCTCTCTAAC
AGTCCACTTGGTACCTCCTA -> GTCCACTTGGTACCTCCTAA
AGTCCGGCCCGGCTATATAA -> GTCCGGCCCGGCTATATAAT
AGTCGATTAGTCCACTTGGT -> GTCGATTAGTCCACTTGGTA
AGTGCCTGTCGTCCAAAGCA -> GTGCCTGTCGTCCAAAGCAT
AGTGGCTTGTCGTTACCCAA -> GTGGCTTGTCGTTACCCAAC
AGTGTTCAGGTGCGATGGGC -> GTGTTCAGGTGCGATGGGCC
AGTTAGTTCAAGAGCTGAAA -> GTTAGTTCAAGAGCTGAAAG
AGTTCAAGAGCTGAAAGCAA -> GTTCAAGAGCTGAAAGCAAT
AGTTCTGGTGTCTCACGGTA -> GTTCTGGTGTCTCACGGTAC
ATAAAACTTTAAAATAACCA -> TAAAACTTTAAAATAACCAA
ATAACCAAATTAAGTCATTC -> TAACCAAATTAAGTCATTCT
ATAATGCGAGCCTATCCAGC -> TAATGCGAGCCTATCCAGCG
ATACCAGTGGCTTGTCGTTA -> TACCAGTGGCTTGTCGTTAC
ATACCCTTATGAACGTAGCC -> TACCCTTATGAACGTAGCCT
ATACGTTTCTAGTCCGGCCC -> TACGTTTCTAGTCCGGCCCG
ATACTGGATTTACCTGGCTG -> TACTGGATTTACCTGGCTGG
ATAGACTGAAATTATAGGAG -> TAGACTGAAATTATAGGAGG
ATAGAGTGTTCAGGTGCGAT -> TAGAGTGTTCAGGTGCGATG
ATAGCCGAAGGTACGTACGA -> TAGCCGAAGGTACGTACGAT
ATAGGAGGTATTCGAGAGGA -> TAGGAGGTATTCGAGAGGAG
ATAGGTCCAGACAAGAGGAT -> TAGGTCCAGACAAGAGGATG
ATATAAAACTTTAAAATAAC -> TATAAAACTTTAAAATAACC
ATATAATGCGAGCCTATCCA -> TATAATGCGAGCCTATCCAG
ATATACGTTTCTAGTCCGGC -> TATACGTTTCTAGTCCGGCC
ATATAGGTCCAGACAAGAGG -> TATAGGTCCAGACAAGAGGA
ATATATAGGTCCAGACAAGA -> TATATAGGTCCAGACAAGAG
ATATCGCGGAGGTGATACTG -> TATCGCGGAGGTGATACTGG
ATATGAATCCTTAATTGTGC -> TATGAATCCTTAATTGTGCT
ATATTAGAACACATAGCCGA -> TATTAGAACACATAGCCGAA
ATATTCATTTCTTGATTAGC -> TATTCATTTCTTGATTAGCC
ATATTGGCTGCGTGAGACCG -> TATTGGCTGCGTGAGACCGC
ATCACATACCCTTATGAACG -> TCACATACCCTTATGAACGT
ATCCAGCGTCGTTCCGGTCA -> TCCAGCGTCGTTCCGGTCAT
ATCCCGTAGTTCTGGTGTCT -> TCCCGTAGTTCTGGTGTCTC
ATCCGCTGGCAAGGGACATG -> TCCGCTGGCAAGGGACATGG
ATCCGGGCCGTTTGACTGTA -> TCCGGGCCGTTTGACTGTAT
ATCCTTAATTGTGCTGCAGA -> TCCTTAATTGTGCTGCAGAT
ATCGCGGAGGTGATACTGGA -> TCGCGGAGGTGATACTGGAT
ATCGTAACGCGCTGATCCGG -> TCGTAACGCGCTGATCCGGG
ATCTCTGCGTTTCTGGGTAA -> TCTCTGCGTTTCTGGGTAAT
ATGAACGTAGCCTATATTGG -> TGAACGTAGCCTATATTGGC
ATGAATCCTTAATTGTGCTG -> TGAATCCTTAATTGTGCTGC
ATGCACAGAACAGGCTCAAG -> TGCACAGAACAGGCTCAAGG
ATGCCGTCCCGTGCCAATGT -> TGCCGTCCCGTGCCAATGTG
ATGCGAGCCTATCCAGCGTC -> TGCGAGCCTATCCAGCGTCG
ATGCGGGCGTGGATGTGCTC -> TGCGGGCGTGGATGTGCTCG
ATGGAGTACCTACCGCAAAC -> TGGAGTACCTACCGCAAACA
ATGGGCCGGGTTCTATACGA -> TGGGCCGGGTTCTATACGAA
ATGGTTCGTCGGTATATTAG -> TGGTTCGTCGGTATATTAGA
ATGTGATTCGAGTCACATCT -> TGTGATTCGAGTCACATCTC
ATGTGCTCGGGTTAGGGATC -> TGTGCTCGGGTTAGGGATCA
ATGTTCCCTTGTTACATCCC -> TGTTCCCTTGTTACATCCCG
ATGTTTTCATAGAGTGTTCA -> TGTTTTCATAGAGTGTTCAG
ATTAAGTCATTCTGTTCTCT -> TTAAGTCATTCTGTTCTCTC
ATTACCACACGCGAGAGCTG -> TTACCACACGCGAGAGCTGG
ATTAGAACACATAGCCGAAG -> TTAGAACACATAGCCGAAGG
ATTAGCCTCACCTGGATTGT -> TTAGCCTCACCTGGATTGTA
ATTAGTCCACTTGGTACCTC -> TTAGTCCACTTGGTACCTCC
ATTATAGGAGGTATTCGAGA -> TTATAGGAGGTATTCGAGAG
ATTATTACCACACGCGAGAG -> TTATTACCACACGCGAGAGC
ATTCATTTCTTGATTAGCCT -> TTCATTTCTTGATTAGCCTC
ATTCGAGAGGAGCAACCCTC -> TTCGAGAGGAGCAACCCTCA
ATTCGAGTCACATCTCTGCG -> TTCGAGTCACATCTCTGCGT
ATTCGCCAATTGCGGGTCAG -> TTCGCCAATTGCGGGTCAGT
ATTCTCTTCAATGCCGTCCC -> TTCTCTTCAATGCCGTCCCG
ATTCTGTTCTCTCTAACTCC -> TTCTGTTCTCTCTAACTCCA
ATTGATATAAAACTTTAAAA -> TTGATATAAAACTTTAAAAT
ATTGCCGGAGCTGGCCACCG -> TTGCCGGAGCTGGCCACCGT
ATTGCGGGTCAGTTAGTTCA -> TTGCGGGTCAGTTAGTTCAA
ATTGGACGTAACGTGTCCCG -> TTGGACGTAACGTGTCCCGG
ATTGGCTGCGTGAGACCGCT -> TTGGCTGCGTGAGACCGCTA
ATTGTAACGGCAAATATACG -> TTGTAACGGCAAATATACGT
ATTGTGCTGCAGATAGACTG -> TTGTGCTGCAGATAGACTGA
ATTTACCTGGCTGGCCCACG -> TTTACCTGGCTGGCCCACGA
ATTTCTTGATTAGCCTCACC -> TTTCTTGATTAGCCTCACCT
CAAACACGTGCCTGGACGAG -> AAACACGTGCCTGGACGAGG
CAAACGAATGCACAGAACAG -> AAACGAATGCACAGAACAGG
CAAAGCATGCGGGCGTGGAT -> AAAGCATGCGGGCGTGGATG
CAAATATACGTTTCTAGTCC -> AAATATACGTTTCTAGTCCG
CAAATTAAGTCATTCTGTTC -> AAATTAAGTCATTCTGTTCT
CAACAACGGTGGAGAAACTG -> AACAACGGTGGAGAAACTGA
CAACATGTTTTCATAGAGTG -> AACATGTTTTCATAGAGTGT
CAACCCTCAGTCGATTAGTC -> AACCCTCAGTCGATTAGTCC
CAACGGTGGAGAAACTGAAG -> AACGGTGGAGAAACTGAAGC
CAACTGCGTGTTGGGCAGTC -> AACTGCGTGTTGGGCAGTCA
CAAGAGCTGAAAGCAATATG -> AAGAGCTGAAAGCAATATGA
CAAGAGGATGGTTCGTCGGT -> AAGAGGATGGTTCGTCGGTA
CAAGGAATATATAGGTCCAG -> AAGGAATATATAGGTCCAGA
CAAGGGACATGGAGTACCTA -> AAGGGACATGGAGTACCTAC
CAATATCGCGGAGGTGATAC -> AATATCGCGGAGGTGATACT
CAATATGAATCCTTAATTGT -> AATATGAATCCTTAATTGTG
CAATGCCGTCCCGTGCCAAT -> AATGCCGTCCCGTGCCAATG
CAATGTGATTCGAGTCACAT -> AATGTGATTCGAGTCACATC
CAATTCGCCAATTGCGGGTC -> AATTCGCCAATTGCGGGTCA
CAATTGCGGGTCAGTTAGTT -> AATTGCGGGTCAGTTAGTTC
CACAATATCGCGGAGGTGAT -> ACAATATCGCGGAGGTGATA
CACACGCGAGAGCTGGCGGC -> ACACGCGAGAGCTGGCGGCC
CACAGAACAGGCTCAAGGAA -> ACAGAACAGGCTCAAGGAAT
CACATACCCTTATGAACGTA -> ACATACCCTTATGAACGTAG
CACATAGCCGAAGGTACGTA -> ACATAGCCGAAGGTACGTAC
CACATCTCTGCGTTTCTGGG -> ACATCTCTGCGTTTCTGGGT
CACCACGGAGGCGGACCGGA -> ACCACGGAGGCGGACCGGAA
CACCGTAGGCGAGTGCCTGT -> ACCGTAGGCGAGTGCCTGTC
CACCTGGATTGTAACGGCAA -> ACCTGGATTGTAACGGCAAA
CACGATGTTCCCTTGTTACA -> ACGATGTTCCCTTGTTACAT
CACGCGAGAGCTGGCGGCCT -> ACGCGAGAGCTGGCGGCCTT
CACGGAGGCGGACCGGAAGA -> ACGGAGGCGGACCGGAAGAT
CACGGTACGGTCAATTCGCC -> ACGGTACGGTCAATTCGCCA
CACGTGCCTGGACGAGGGTC -> ACGTGCCTGGACGAGGGTCC
CACTCCCAACATGTTTTCAT -> ACTCCCAACATGTTTTCATA
CACTTGGTACCTCCTAAAGG -> ACTTGGTACCTCCTAAAGGG
CAGAACAGGCTCAAGGAATA -> AGAACAGGCTCAAGGAATAT
CAGACAAGAGGATGGTTCGT -> AGACAAGAGGATGGTTCGTC
CAGATAGACTGAAATTATAG -> AGATAGACTGAAATTATAGG
CAGCGTCGTTCCGGTCATAC -> AGCGTCGTTCCGGTCATACC
CAGCTTGCTTGACGCCACAA -> AGCTTGCTTGACGCCACAAT
CAGGCTCAAGGAATATATAG -> AGGCTCAAGGAATATATAGG
CAGGTGCGATGGGCCGGGTT -> AGGTGCGATGGGCCGGGTTC
CAGTCACCACGGAGGCGGAC -> AGTCACCACGGAGGCGGACC
CAGTCGATTAGTCCACTTGG -> AGTCGATTAGTCCACTTGGT
CAGTGGCTTGTCGTTACCCA -> AGTGGCTTGTCGTTACCCAA
CAGTTAGTTCAAGAGCTGAA -> AGTTAGTTCAAGAGCTGAAA
CATACCAGTGGCTTGTCGTT -> ATACCAGTGGCTTGTCGTTA
CATACCCTTATGAACGTAGC -> ATACCCTTATGAACGTAGCC
CATAGAGTGTTCAGGTGCGA -> ATAGAGTGTTCAGGTGCGAT
CATAGCCGAAGGTACGTACG -> ATAGCCGAAGGTACGTACGA
CATCCCGTAGTTCTGGTGTC -> ATCCCGTAGTTCTGGTGTCT
CATCTCTGCGTTTCTGGGTA -> ATCTCTGCGTTTCTGGGTAA
CATGCGGGCGTGGATGTGCT -> ATGCGGGCGTGGATGTGCTC
CATGGAGTACCTACCGCAAA -> ATGGAGTACCTACCGCAAAC
CATGTTTTCATAGAGTGTTC -> ATGTTTTCATAGAGTGTTCA
CATTCTGTTCTCTCTAACTC -> ATTCTGTTCTCTCTAACTCC
CATTGATATAAAACTTTAAA -> ATTGATATAAAACTTTAAAA
CATTGCCGGAGCTGGCCACC -> ATTGCCGGAGCTGGCCACCG
CATTTCTTGATTAGCCTCAC -> ATTTCTTGATTAGCCTCACC
CCAAACGAATGCACAGAACA -> CAAACGAATGCACAGAACAG
CCAAAGCATGCGGGCGTGGA -> CAAAGCATGCGGGCGTGGAT
CCAAATTAAGTCATTCTGTT -> CAAATTAAGTCATTCTGTTC
CCAACAACGGTGGAGAAACT -> CAACAACGGTGGAGAAACTG
CCAACATGTTTTCATAGAGT -> CAACATGTTTTCATAGAGTG
CCAACTGCGTGTTGGGCAGT -> CAACTGCGTGTTGGGCAGTC
CCAATGTGATTCGAGTCACA -> CAATGTGATTCGAGTCACAT
CCAATTGCGGGTCAGTTAGT -> CAATTGCGGGTCAGTTAGTT
CCACAATATCGCGGAGGTGA -> CACAATATCGCGGAGGTGAT
CCACACGCGAGAGCTGGCGG -> CACACGCGAGAGCTGGCGGC
CCACCGTAGGCGAGTGCCTG -> CACCGTAGGCGAGTGCCTGT
CCACGATGTTCCCTTGTTAC -> CACGATGTTCCCTTGTTACA
CCACGGAGGCGGACCGGAAG -> CACGGAGGCGGACCGGAAGA
CCACTTGGTACCTCCTAAAG -> CACTTGGTACCTCCTAAAGG
CCAGACAAGAGGATGGTTCG -> CAGACAAGAGGATGGTTCGT
CCAGCGTCGTTCCGGTCATA -> CAGCGTCGTTCCGGTCATAC
CCAGTGGCTTGTCGTTACCC -> CAGTGGCTTGTCGTTACCCA
CCCAAACGAATGCACAGAAC -> CCAAACGAATGCACAGAACA
CCCAACATGTTTTCATAGAG -> CCAACATGTTTTCATAGAGT
CCCAACTGCGTGTTGGGCAG -> CCAACTGCGTGTTGGGCAGT
CCCACGATGTTCCCTTGTTA -> CCACGATGTTCCCTTGTTAC
CCCGGCTATATAATGCGAGC -> CCGGCTATATAATGCGAGCC
CCCGGGCGAGGCAGCTTGCT -> CCGGGCGAGGCAGCTTGCTT
CCCGTAGTTCTGGTGTCTCA -> CCGTAGTTCTGGTGTCTCAC
CCCGTGCCAATGTGATTCGA -> CCGTGCCAATGTGATTCGAG
CCCTCAGTCGATTAGTCCAC -> CCTCAGTCGATTAGTCCACT
CCCTTATGAACGTAGCCTAT -> CCTTATGAACGTAGCCTATA
CCCTTGTTACATCCCGTAGT -> CCTTGTTACATCCCGTAGTT
CCGAAGGTACGTACGATTAT -> CGAAGGTACGTACGATTATT
CCGCAAACACGTGCCTGGAC -> CGCAAACACGTGCCTGGACG
CCGCTAGGGGTTCTATTGGA -> CGCTAGGGGTTCTATTGGAC
CCGCTGGCAAGGGACATGGA -> CGCTGGCAAGGGACATGGAG
CCGGAAGATCGTAACGCGCT -> CGGAAGATCGTAACGCGCTG
CCGGAGCTGGCCACCGTAGG -> CGGAGCTGGCCACCGTAGGC
CCGGCCCGGCTATATAATGC -> CGGCCCGGCTATATAATGCG
CCGGCTATATAATGCGAGCC -> CGGCTATATAATGCGAGCCT
CCGGGCCGTTTGACTGTATC -> CGGGCCGTTTGACTGTATCC
CCGGGCGAGGCAGCTTGCTT -> CGGGCGAGGCAGCTTGCTTG
CCGGGTTCTATACGAATACA -> CGGGTTCTATACGAATACAG
CCGGTCATACCAGTGGCTTG -> CGGTCATACCAGTGGCTTGT
CCGTAGGCGAGTGCCTGTCG -> CGTAGGCGAGTGCCTGTCGT
CCGTAGTTCTGGTGTCTCAC -> CGTAGTTCTGGTGTCTCACG
CCGTCCCGTGCCAATGTGAT -> CGTCCCGTGCCAATGTGATT
CCGTGCCAATGTGATTCGAG -> CGTGCCAATGTGATTCGAGT
CCGTTTGACTGTATCCGCTG -> CGTTTGACTGTATCCGCTGG
CCTAAAGGGTCATTGATATA -> CTAAAGGGTCATTGATATAA
CCTACCGCAAACACGTGCCT -> CTACCGCAAACACGTGCCTG
CCTATATTGGCTGCGTGAGA -> CTATATTGGCTGCGTGAGAC
CCTATCCAGCGTCGTTCCGG -> CTATCCAGCGTCGTTCCGGT
CCTCACCTGGATTGTAACGG -> CTCACCTGGATTGTAACGGC
CCTCAGTCGATTAGTCCACT -> CTCAGTCGATTAGTCCACTT
CCTCCTAAAGGGTCATTGAT -> CTCCTAAAGGGTCATTGATA
CCTGGACGAGGGTCCCAAAC -> CTGGACGAGGGTCCCAAACG
CCTGGATTGTAACGGCAAAT -> CTGGATTGTAACGGCAAATA
CCTGGCTGGCCCACGATGTT -> CTGGCTGGCCCACGATGTTC
CCTGTCGTCCAAAGCATGCG -> CTGTCGTCCAAAGCATGCGG
CCTTAATTGTGCTGCAGATA -> CTTAATTGTGCTGCAGATAG
CCTTATGAACGTAGCCTATA -> CTTATGAACGTAGCCTATAT
CCTTGTCTCATTGCCGGAGC -> CTTGTCTCATTGCCGGAGCT
CCTTGTTACATCCCGTAGTT -> CTTGTTACATCCCGTAGTTC
CGAAGGTACGTACGATTATT -> GAAGGTACGTACGATTATTA
CGAATGCACAGAACAGGCTC -> GAATGCACAGAACAGGCTCA
CGAGAGCTGGCGGCCTTGTC -> GAGAGCTGGCGGCCTTGTCT
CGAGAGGAGCAACCCTCAGT -> GAGAGGAGCAACCCTCAGTC
CGAGCCTATCCAGCGTCGTT -> GAGCCTATCCAGCGTCGTTC
CGAGGCAGCTTGCTTGACGC -> GAGGCAGCTTGCTTGACGCC
CGAGGGTCCCAAACGAATGC -> GAGGGTCCCAAACGAATGCA
CGAGTCACATCTCTGCGTTT -> GAGTCACATCTCTGCGTTTC
CGAGTGCCTGTCGTCCAAAG -> GAGTGCCTGTCGTCCAAAGC
CGATGGGCCGGGTTCTATAC -> GATGGGCCGGGTTCTATACG
CGATGTTCCCTTGTTACATC -> GATGTTCCCTTGTTACATCC
CGATTAGTCCACTTGGTACC -> GATTAGTCCACTTGGTACCT
CGATTATTACCACACGCGAG -> GATTATTACCACACGCGAGA
CGCAAACACGTGCCTGGACG -> GCAAACACGTGCCTGGACGA
CGCCAATTGCGGGTCAGTTA -> GCCAATTGCGGGTCAGTTAG
CGCCACAATATCGCGGAGGT -> GCCACAATATCGCGGAGGTG
CGCGAGAGCTGGCGGCCTTG -> GCGAGAGCTGGCGGCCTTGT
CGCGCTGATCCGGGCCGTTT -> GCGCTGATCCGGGCCGTTTG
CGCGGAGGTGATACTGGATT -> GCGGAGGTGATACTGGATTT
CGCTAGGGGTTCTATTGGAC -> GCTAGGGGTTCTATTGGACG
CGCTGATCCGGGCCGTTTGA -> GCTGATCCGGGCCGTTTGAC
CGCTGGCAAGGGACATGGAG -> GCTGGCAAGGGACATGGAGT
CGGAAGATCGTAACGCGCTG -> GGAAGATCGTAACGCGCTGA
CGGACCGGAAGATCGTAACG -> GGACCGGAAGATCGTAACGC
CGGAGCTGGCCACCGTAGGC -> GGAGCTGGCCACCGTAGGCG
CGGAGGCGGACCGGAAGATC -> GGAGGCGGACCGGAAGATCG
CGGAGGTGATACTGGATTTA -> GGAGGTGATACTGGATTTAC
CGGCAAATATACGTTTCTAG -> GGCAAATATACGTTTCTAGT
CGGCCCGGCTATATAATGCG -> GGCCCGGCTATATAATGCGA
CGGCCTTGTCTCATTGCCGG -> GGCCTTGTCTCATTGCCGGA
CGGCTATATAATGCGAGCCT -> GGCTATATAATGCGAGCCTA
CGGGCCGTTTGACTGTATCC -> GGGCCGTTTGACTGTATCCG
CGGGCGAGGCAGCTTGCTTG -> GGGCGAGGCAGCTTGCTTGA
CGGGCGTGGATGTGCTCGGG -> GGGCGTGGATGTGCTCGGGT
CGGGTCAGTTAGTTCAAGAG -> GGGTCAGTTAGTTCAAGAGC
CGGGTTAGGGATCACATACC -> GGGTTAGGGATCACATACCC
CGGGTTCTATACGAATACAG -> GGGTTCTATACGAATACAGC
CGGTACGGTCAATTCGCCAA -> GGTACGGTCAATTCGCCAAT
CGGTATATTAGAACACATAG -> GGTATATTAGAACACATAGC
CGGTCAATTCGCCAATTGCG -> GGTCAATTCGCCAATTGCGG
CGGTCATACCAGTGGCTTGT -> GGTCATACCAGTGGCTTGTC
CGGTGGAGAAACTGAAGCAC -> GGTGGAGAAACTGAAGCACT
CGTAACGCGCTGATCCGGGC -> GTAACGCGCTGATCCGGGCC
CGTAACGTGTCCCGGGCGAG -> GTAACGTGTCCCGGGCGAGG
CGTACGATTATTACCACACG -> GTACGATTATTACCACACGC
CGTAGCCTATATTGGCTGCG -> GTAGCCTATATTGGCTGCGT
CGTAGGCGAGTGCCTGTCGT -> GTAGGCGAGTGCCTGTCGTC
CGTAGTTCTGGTGTCTCACG -> GTAGTTCTGGTGTCTCACGG
CGTCCAAAGCATGCGGGCGT -> GTCCAAAGCATGCGGGCGTG
CGTCCCGTGCCAATGTGATT -> GTCCCGTGCCAATGTGATTC
CGTCGGTATATTAGAACACA -> GTCGGTATATTAGAACACAT
CGTCGTTCCGGTCATACCAG -> GTCGTTCCGGTCATACCAGT
CGTGAGACCGCTAGGGGTTC -> GTGAGACCGCTAGGGGTTCT
CGTGCCAATGTGATTCGAGT -> GTGCCAATGTGATTCGAGTC
CGTGCCTGGACGAGGGTCCC -> GTGCCTGGACGAGGGTCCCA
CGTGGATGTGCTCGGGTTAG -> GTGGATGTGCTCGGGTTAGG
CGTGTCCCGGGCGAGGCAGC -> GTGTCCCGGGCGAGGCAGCT
CGTGTTGGGCAGTCACCACG -> GTGTTGGGCAGTCACCACGG
CGTTACCCAACTGCGTGTTG -> GTTACCCAACTGCGTGTTGG
CGTTCCGGTCATACCAGTGG -> GTTCCGGTCATACCAGTGGC
CGTTTCTAGTCCGGCCCGGC -> GTTTCTAGTCCGGCCCGGCT
CGTTTCTGGGTAATATTCAT -> GTTTCTGGGTAATATTCATT
CGTTTGACTGTATCCGCTGG -> GTTTGACTGTATCCGCTGGC
CTAAAGGGTCATTGATATAA -> TAAAGGGTCATTGATATAAA
CTAACTCCAACAACGGTGGA -> TAACTCCAACAACGGTGGAG
CTACCGCAAACACGTGCCTG -> TACCGCAAACACGTGCCTGG
CTAGGGGTTCTATTGGACGT -> TAGGGGTTCTATTGGACGTA
CTAGTCCGGCCCGGCTATAT -> TAGTCCGGCCCGGCTATATA
CTATATAATGCGAGCCTATC -> TATATAATGCGAGCCTATCC
CTATATTGGCTGCGTGAGAC -> TATATTGGCTGCGTGAGACC
CTATCCAGCGTCGTTCCGGT -> TATCCAGCGTCGTTCCGGTC
CTATTGGACGTAACGTGTCC -> TATTGGACGTAACGTGTCCC
CTCAAGGAATATATAGGTCC -> TCAAGGAATATATAGGTCCA
CTCACCTGGATTGTAACGGC -> TCACCTGGATTGTAACGGCA
CTCACGGTACGGTCAATTCG -> TCACGGTACGGTCAATTCGC
CTCAGTCGATTAGTCCACTT -> TCAGTCGATTAGTCCACTTG
CTCATTGCCGGAGCTGGCCA -> TCATTGCCGGAGCTGGCCAC
CTCCAACAACGGTGGAGAAA -> TCCAACAACGGTGGAGAAAC
CTCCCAACATGTTTTCATAG -> TCCCAACATGTTTTCATAGA
CTCCTAAAGGGTCATTGATA -> TCCTAAAGGGTCATTGATAT
CTCGGGTTAGGGATCACATA -> TCGGGTTAGGGATCACATAC
CTCTAACTCCAACAACGGTG -> TCTAACTCCAACAACGGTGG
CTCTCTAACTCCAACAACGG -> TCTCTAACTCCAACAACGGT
CTCTGCGTTTCTGGGTAATA -> TCTGCGTTTCTGGGTAATAT
CTCTTCAATGCCGTCCCGTG -> TCTTCAATGCCGTCCCGTGC
CTGAAAGCAATATGAATCCT -> TGAAAGCAATATGAATCCTT
CTGAAATTATAGGAGGTATT -> TGAAATTATAGGAGGTATTC
CTGAAGCACTCCCAACATGT -> TGAAGCACTCCCAACATGTT
CTGATCCGGGCCGTTTGACT -> TGATCCGGGCCGTTTGACTG
CTGCAGATAGACTGAAATTA -> TGCAGATAGACTGAAATTAT
CTGCGTGAGACCGCTAGGGG -> TGCGTGAGACCGCTAGGGGT
CTGCGTGTTGGGCAGTCACC -> TGCGTGTTGGGCAGTCACCA
CTGCGTTTCTGGGTAATATT -> TGCGTTTCTGGGTAATATTC
CTGGACGAGGGTCCCAAACG -> TGGACGAGGGTCCCAAACGA
CTGGATTGTAACGGCAAATA -> TGGATTGTAACGGCAAATAT
CTGGATTTACCTGGCTGGCC -> TGGATTTACCTGGCTGGCCC
CTGGCAAGGGACATGGAGTA -> TGGCAAGGGACATGGAGTAC
CTGGCCACCGTAGGCGAGTG -> TGGCCACCGTAGGCGAGTGC
CTGGCCCACGATGTTCCCTT -> TGGCCCACGATGTTCCCTTG
CTGGCGGCCTTGTCTCATTG -> TGGCGGCCTTGTCTCATTGC
CTGGCTGGCCCACGATGTTC -> TGGCTGGCCCACGATGTTCC
CTGGGTAATATTCATTTCTT -> TGGGTAATATTCATTTCTTG
CTGGTGTCTCACGGTACGGT -> TGGTGTCTCACGGTACGGTC
CTGTATCCGCTGGCAAGGGA -> TGTATCCGCTGGCAAGGGAC
CTGTCGTCCAAAGCATGCGG -> TGTCGTCCAAAGCATGCGGG
CTGTTCTCTCTAACTCCAAC -> TGTTCTCTCTAACTCCAACA
CTTAATTGTGCTGCAGATAG -> TTAATTGTGCTGCAGATAGA
CTTATGAACGTAGCCTATAT -> TTATGAACGTAGCCTATATT
CTTCAATGCCGTCCCGTGCC -> TTCAATGCCGTCCCGTGCCA
CTTGACGCCACAATATCGCG -> TTGACGCCACAATATCGCGG
CTTGATTAGCCTCACCTGGA -> TTGATTAGCCTCACCTGGAT
CTTGCTTGACGCCACAATAT -> TTGCTTGACGCCACAATATC
CTTGGTACCTCCTAAAGGGT -> TTGGTACCTCCTAAAGGGTC
CTTGTCGTTACCCAACTGCG -> TTGTCGTTACCCAACTGCGT
CTTGTCTCATTGCCGGAGCT -> TTGTCTCATTGCCGGAGCTG
CTTGTTACATCCCGTAGTTC -> TTGTTACATCCCGTAGTTCT
CTTTAAAATAACCAAATTAA -> TTTAAAATAACCAAATTAAG
GAAACTGAAGCACTCCCAAC -> AAACTGAAGCACTCCCAACA
GAAAGCAATATGAATCCTTA -> AAAGCAATATGAATCCTTAA
GAAATTATAGGAGGTATTCG -> AAATTATAGGAGGTATTCGA
GAACACATAGCCGAAGGTAC -> AACACATAGCCGAAGGTACG
GAACAGGCTCAAGGAATATA -> AACAGGCTCAAGGAATATAT
GAACGTAGCCTATATTGGCT -> AACGTAGCCTATATTGGCTG
GAAGATCGTAACGCGCTGAT -> AAGATCGTAACGCGCTGATC
GAAGCACTCCCAACATGTTT -> AAGCACTCCCAACATGTTTT
GAAGGTACGTACGATTATTA -> AAGGTACGTACGATTATTAC
GAATATATAGGTCCAGACAA -> AATATATAGGTCCAGACAAG
GAATCCTTAATTGTGCTGCA -> AATCCTTAATTGTGCTGCAG
GAATGCACAGAACAGGCTCA -> AATGCACAGAACAGGCTCAA
GACAAGAGGATGGTTCGTCG -> ACAAGAGGATGGTTCGTCGG
GACATGGAGTACCTACCGCA -> ACATGGAGTACCTACCGCAA
GACCGCTAGGGGTTCTATTG -> ACCGCTAGGGGTTCTATTGG
GACCGGAAGATCGTAACGCG -> ACCGGAAGATCGTAACGCGC
GACGAGGGTCCCAAACGAAT -> ACGAGGGTCCCAAACGAATG
GACGCCACAATATCGCGGAG -> ACGCCACAATATCGCGGAGG
GACGTAACGTGTCCCGGGCG -> ACGTAACGTGTCCCGGGCGA
GACTGAAATTATAGGAGGTA -> ACTGAAATTATAGGAGGTAT
GACTGTATCCGCTGGCAAGG -> ACTGTATCCGCTGGCAAGGG
GAGAAACTGAAGCACTCCCA -> AGAAACTGAAGCACTCCCAA
GAGACCGCTAGGGGTTCTAT -> AGACCGCTAGGGGTTCTATT
GAGAGCTGGCGGCCTTGTCT -> AGAGCTGGCGGCCTTGTCTC
GAGAGGAGCAACCCTCAGTC -> AGAGGAGCAACCCTCAGTCG
GAGCAACCCTCAGTCGATTA -> AGCAACCCTCAGTCGATTAG
GAGCCTATCCAGCGTCGTTC -> AGCCTATCCAGCGTCGTTCC
GAGCTGAAAGCAATATGAAT -> AGCTGAAAGCAATATGAATC
GAGCTGGCCACCGTAGGCGA -> AGCTGGCCACCGTAGGCGAG
GAGCTGGCGGCCTTGTCTCA -> AGCTGGCGGCCTTGTCTCAT
GAGGAGCAACCCTCAGTCGA -> AGGAGCAACCCTCAGTCGAT
GAGGATGGTTCGTCGGTATA -> AGGATGGTTCGTCGGTATAT
GAGGCAGCTTGCTTGACGCC -> AGGCAGCTTGCTTGACGCCA
GAGGCGGACCGGAAGATCGT -> AGGCGGACCGGAAGATCGTA
GAGGGTCCCAAACGAATGCA -> AGGGTCCCAAACGAATGCAC
GAGGTATTCGAGAGGAGCAA -> AGGTATTCGAGAGGAGCAAC
GAGGTGATACTGGATTTACC -> AGGTGATACTGGATTTACCT
GAGTACCTACCGCAAACACG -> AGTACCTACCGCAAACACGT
GAGTCACATCTCTGCGTTTC -> AGTCACATCTCTGCGTTTCT
GAGTGCCTGTCGTCCAAAGC -> AGTGCCTGTCGTCCAAAGCA
GAGTGTTCAGGTGCGATGGG -> AGTGTTCAGGTGCGATGGGC
GATACTGGATTTACCTGGCT -> ATACTGGATTTACCTGGCTG
GATAGACTGAAATTATAGGA -> ATAGACTGAAATTATAGGAG
GATATAAAACTTTAAAATAA -> ATATAAAACTTTAAAATAAC
GATCACATACCCTTATGAAC -> ATCACATACCCTTATGAACG
GATCCGGGCCGTTTGACTGT -> ATCCGGGCCGTTTGACTGTA
GATCGTAACGCGCTGATCCG -> ATCGTAACGCGCTGATCCGG
GATGGGCCGGGTTCTATACG -> ATGGGCCGGGTTCTATACGA
GATGGTTCGTCGGTATATTA -> ATGGTTCGTCGGTATATTAG
GATGTGCTCGGGTTAGGGAT -> ATGTGCTCGGGTTAGGGATC
GATGTTCCCTTGTTACATCC -> ATGTTCCCTTGTTACATCCC
GATTAGCCTCACCTGGATTG -> ATTAGCCTCACCTGGATTGT
GATTAGTCCACTTGGTACCT -> ATTAGTCCACTTGGTACCTC
GATTATTACCACACGCGAGA -> ATTATTACCACACGCGAGAG
GATTCGAGTCACATCTCTGC -> ATTCGAGTCACATCTCTGCG
GATTCTCTTCAATGCCGTCC -> ATTCTCTTCAATGCCGTCCC
GATTGTAACGGCAAATATAC -> ATTGTAACGGCAAATATACG
GATTTACCTGGCTGGCCCAC -> ATTTACCTGGCTGGCCCACG
GCAAACACGTGCCTGGACGA -> CAAACACGTGCCTGGACGAG
GCAAATATACGTTTCTAGTC -> CAAATATACGTTTCTAGTCC
GCAACCCTCAGTCGATTAGT -> CAACCCTCAGTCGATTAGTC
GCAAGGGACATGGAGTACCT -> CAAGGGACATGGAGTACCTA
GCAATATGAATCCTTAATTG -> CAATATGAATCCTTAATTGT
GCACAGAACAGGCTCAAGGA -> CACAGAACAGGCTCAAGGAA
GCACTCCCAACATGTTTTCA -> CACTCCCAACATGTTTTCAT
GCAGATAGACTGAAATTATA -> CAGATAGACTGAAATTATAG
GCAGCTTGCTTGACGCCACA -> CAGCTTGCTTGACGCCACAA
GCAGTCACCACGGAGGCGGA -> CAGTCACCACGGAGGCGGAC
GCATGCGGGCGTGGATGTGC -> CATGCGGGCGTGGATGTGCT
GCCAATGTGATTCGAGTCAC -> CCAATGTGATTCGAGTCACA
GCCAATTGCGGGTCAGTTAG -> CCAATTGCGGGTCAGTTAGT
GCCACAATATCGCGGAGGTG -> CCACAATATCGCGGAGGTGA
GCCACCGTAGGCGAGTGCCT -> CCACCGTAGGCGAGTGCCTG
GCCCACGATGTTCCCTTGTT -> CCCACGATGTTCCCTTGTTA
GCCCGGCTATATAATGCGAG -> CCCGGCTATATAATGCGAGC
GCCGAAGGTACGTACGATTA -> CCGAAGGTACGTACGATTAT
GCCGGAGCTGGCCACCGTAG -> CCGGAGCTGGCCACCGTAGG
GCCGGGTTCTATACGAATAC -> CCGGGTTCTATACGAATACA
GCCGTCCCGTGCCAATGTGA -> CCGTCCCGTGCCAATGTGAT
GCCGTTTGACTGTATCCGCT -> CCGTTTGACTGTATCCGCTG
GCCTATATTGGCTGCGTGAG -> CCTATATTGGCTGCGTGAGA
GCCTATCCAGCGTCGTTCCG -> CCTATCCAGCGTCGTTCCGG
GCCTCACCTGGATTGTAACG -> CCTCACCTGGATTGTAACGG
GCCTGGACGAGGGTCCCAAA -> CCTGGACGAGGGTCCCAAAC
GCCTGTCGTCCAAAGCATGC -> CCTGTCGTCCAAAGCATGCG
GCCTTGTCTCATTGCCGGAG -> CCTTGTCTCATTGCCGGAGC
GCGAGAGCTGGCGGCCTTGT -> CGAGAGCTGGCGGCCTTGTC
GCGAGCCTATCCAGCGTCGT -> CGAGCCTATCCAGCGTCGTT
GCGAGGCAGCTTGCTTGACG -> CGAGGCAGCTTGCTTGACGC
GCGAGTGCCTGTCGTCCAAA -> CGAGTGCCTGTCGTCCAAAG
GCGATGGGCCGGGTTCTATA -> CGATGGGCCGGGTTCTATAC
GCGCTGATCCGGGCCGTTTG -> CGCTGATCCGGGCCGTTTGA
GCGGACCGGAAGATCGTAAC -> CGGACCGGAAGATCGTAACG
GCGGAGGTGATACTGGATTT -> CGGAGGTGATACTGGATTTA
GCGGCCTTGTCTCATTGCCG -> CGGCCTTGTCTCATTGCCGG
GCGGGCGTGGATGTGCTCGG -> CGGGCGTGGATGTGCTCGGG
GCGGGTCAGTTAGTTCAAGA -> CGGGTCAGTTAGTTCAAGAG
GCGTCGTTCCGGTCATACCA -> CGTCGTTCCGGTCATACCAG
GCGTGAGACCGCTAGGGGTT -> CGTGAGACCGCTAGGGGTTC
GCGTGGATGTGCTCGGGTTA -> CGTGGATGTGCTCGGGTTAG
GCGTGTTGGGCAGTCACCAC -> CGTGTTGGGCAGTCACCACG
GCGTTTCTGGGTAATATTCA -> CGTTTCTGGGTAATATTCAT
GCTAGGGGTTCTATTGGACG -> CTAGGGGTTCTATTGGACGT
GCTATATAATGCGAGCCTAT -> CTATATAATGCGAGCCTATC
GCTCAAGGAATATATAGGTC -> CTCAAGGAATATATAGGTCC
GCTCGGGTTAGGGATCACAT -> CTCGGGTTAGGGATCACATA
GCTGAAAGCAATATGAATCC -> CTGAAAGCAATATGAATCCT
GCTGATCCGGGCCGTTTGAC -> CTGATCCGGGCCGTTTGACT
GCTGCAGATAGACTGAAATT -> CTGCAGATAGACTGAAATTA
GCTGCGTGAGACCGCTAGGG -> CTGCGTGAGACCGCTAGGGG
GCTGGCAAGGGACATGGAGT -> CTGGCAAGGGACATGGAGTA
GCTGGCCACCGTAGGCGAGT -> CTGGCCACCGTAGGCGAGTG
GCTGGCCCACGATGTTCCCT -> CTGGCCCACGATGTTCCCTT
GCTGGCGGCCTTGTCTCATT -> CTGGCGGCCTTGTCTCATTG
GCTTGACGCCACAATATCGC -> CTTGACGCCACAATATCGCG
GCTTGCTTGACGCCACAATA -> CTTGCTTGACGCCACAATAT
GCTTGTCGTTACCCAACTGC -> CTTGTCGTTACCCAACTGCG
GGAAGATCGTAACGCGCTGA -> GAAGATCGTAACGCGCTGAT
GGAATATATAGGTCCAGACA -> GAATATATAGGTCCAGACAA
GGACATGGAGTACCTACCGC -> GACATGGAGTACCTACCGCA
GGACCGGAAGATCGTAACGC -> GACCGGAAGATCGTAACGCG
GGACGAGGGTCCCAAACGAA -> GACGAGGGTCCCAAACGAAT
GGACGTAACGTGTCCCGGGC -> GACGTAACGTGTCCCGGGCG
GGAGAAACTGAAGCACTCCC -> GAGAAACTGAAGCACTCCCA
GGAGCAACCCTCAGTCGATT -> GAGCAACCCTCAGTCGATTA
GGAGCTGGCCACCGTAGGCG -> GAGCTGGCCACCGTAGGCGA
GGAGGCGGACCGGAAGATCG -> GAGGCGGACCGGAAGATCGT
GGAGGTATTCGAGAGGAGCA -> GAGGTATTCGAGAGGAGCAA
GGAGGTGATACTGGATTTAC -> GAGGTGATACTGGATTTACC
GGAGTACCTACCGCAAACAC -> GAGTACCTACCGCAAACACG
GGATCACATACCCTTATGAA -> GATCACATACCCTTATGAAC
GGATGGTTCGTCGGTATATT -> GATGGTTCGTCGGTATATTA
GGATGTGCTCGGGTTAGGGA -> GATGTGCTCGGGTTAGGGAT
GGATTGTAACGGCAAATATA -> GATTGTAACGGCAAATATAC
GGATTTACCTGGCTGGCCCA -> GATTTACCTGGCTGGCCCAC
GGCAAATATACGTTTCTAGT -> GCAAATATACGTTTCTAGTC
GGCAAGGGACATGGAGTACC -> GCAAGGGACATGGAGTACCT
GGCAGCTTGCTTGACGCCAC -> GCAGCTTGCTTGACGCCACA
GGCAGTCACCACGGAGGCGG -> GCAGTCACCACGGAGGCGGA
GGCCACCGTAGGCGAGTGCC -> GCCACCGTAGGCGAGTGCCT
GGCCCACGATGTTCCCTTGT -> GCCCACGATGTTCCCTTGTT
GGCCCGGCTATATAATGCGA -> GCCCGGCTATATAATGCGAG
GGCCGGGTTCTATACGAATA -> GCCGGGTTCTATACGAATAC
GGCCGTTTGACTGTATCCGC -> GCCGTTTGACTGTATCCGCT
GGCCTTGTCTCATTGCCGGA -> GCCTTGTCTCATTGCCGGAG
GGCGAGGCAGCTTGCTTGAC -> GCGAGGCAGCTTGCTTGACG
GGCGAGTGCCTGTCGTCCAA -> GCGAGTGCCTGTCGTCCAAA
GGCGGACCGGAAGATCGTAA -> GCGGACCGGAAGATCGTAAC
GGCGGCCTTGTCTCATTGCC -> GCGGCCTTGTCTCATTGCCG
GGCGTGGATGTGCTCGGGTT -> GCGTGGATGTGCTCGGGTTA
GGCTATATAATGCGAGCCTA -> GCTATATAATGCGAGCCTAT
GGCTCAAGGAATATATAGGT -> GCTCAAGGAATATATAGGTC
GGCTGCGTGAGACCGCTAGG -> GCTGCGTGAGACCGCTAGGG
GGCTGGCCCACGATGTTCCC -> GCTGGCCCACGATGTTCCCT
GGCTTGTCGTTACCCAACTG -> GCTTGTCGTTACCCAACTGC
GGGACATGGAGTACCTACCG -> GGACATGGAGTACCTACCGC
GGGATCACATACCCTTATGA -> GGATCACATACCCTTATGAA
GGGCAGTCACCACGGAGGCG -> GGCAGTCACCACGGAGGCGG
GGGCCGGGTTCTATACGAAT -> GGCCGGGTTCTATACGAATA
GGGCCGTTTGACTGTATCCG -> GGCCGTTTGACTGTATCCGC
GGGCGAGGCAGCTTGCTTGA -> GGCGAGGCAGCTTGCTTGAC
GGGCGTGGATGTGCTCGGGT -> GGCGTGGATGTGCTCGGGTT
GGGGTTCTATTGGACGTAAC -> GGGTTCTATTGGACGTAACG
GGGTAATATTCATTTCTTGA -> GGTAATATTCATTTCTTGAT
GGGTCAGTTAGTTCAAGAGC -> GGTCAGTTAGTTCAAGAGCT
GGGTCATTGATATAAAACTT -> GGTCATTGATATAAAACTTT
GGGTCCCAAACGAATGCACA -> GGTCCCAAACGAATGCACAG
GGGTTAGGGATCACATACCC -> GGTTAGGGATCACATACCCT
GGGTTCTATACGAATACAGC -> GGTTCTATACGAATACAGCC
GGGTTCTATTGGACGTAACG -> GGTTCTATTGGACGTAACGT
GGTAATATTCATTTCTTGAT -> GTAATATTCATTTCTTGATT
GGTACCTCCTAAAGGGTCAT -> GTACCTCCTAAAGGGTCATT
GGTACGGTCAATTCGCCAAT -> GTACGGTCAATTCGCCAATT
GGTACGTACGATTATTACCA -> GTACGTACGATTATTACCAC
GGTATATTAGAACACATAGC -> GTATATTAGAACACATAGCC
GGTATTCGAGAGGAGCAACC -> GTATTCGAGAGGAGCAACCC
GGTCAATTCGCCAATTGCGG -> GTCAATTCGCCAATTGCGGG
GGTCAGTTAGTTCAAGAGCT -> GTCAGTTAGTTCAAGAGCTG
GGTCATACCAGTGGCTTGTC -> GTCATACCAGTGGCTTGTCG
GGTCATTGATATAAAACTTT -> GTCATTGATATAAAACTTTA
GGTCCAGACAAGAGGATGGT -> GTCCAGACAAGAGGATGGTT
GGTCCCAAACGAATGCACAG -> GTCCCAAACGAATGCACAGA
GGTGATACTGGATTTACCTG -> GTGATACTGGATTTACCTGG
GGTGCGATGGGCCGGGTTCT -> GTGCGATGGGCCGGGTTCTA
GGTGGAGAAACTGAAGCACT -> GTGGAGAAACTGAAGCACTC
GGTGTCTCACGGTACGGTCA -> GTGTCTCACGGTACGGTCAA
GGTTAGGGATCACATACCCT -> GTTAGGGATCACATACCCTT
GGTTCGTCGGTATATTAGAA -> GTTCGTCGGTATATTAGAAC
GGTTCTATACGAATACAGCC -> GTTCTATACGAATACAGCCG
GGTTCTATTGGACGTAACGT -> GTTCTATTGGACGTAACGTG
GTAACGCGCTGATCCGGGCC -> TAACGCGCTGATCCGGGCCG
GTAACGGCAAATATACGTTT -> TAACGGCAAATATACGTTTC
GTAACGTGTCCCGGGCGAGG -> TAACGTGTCCCGGGCGAGGC
GTAATATTCATTTCTTGATT -> TAATATTCATTTCTTGATTA
GTACCTACCGCAAACACGTG -> TACCTACCGCAAACACGTGC
GTACCTCCTAAAGGGTCATT -> TACCTCCTAAAGGGTCATTG
GTACGATTATTACCACACGC -> TACGATTATTACCACACGCG
GTACGGTCAATTCGCCAATT -> TACGGTCAATTCGCCAATTG
GTACGTACGATTATTACCAC -> TACGTACGATTATTACCACA
GTAGCCTATATTGGCTGCGT -> TAGCCTATATTGGCTGCGTG
GTAGGCGAGTGCCTGTCGTC -> TAGGCGAGTGCCTGTCGTCC
GTAGTTCTGGTGTCTCACGG -> TAGTTCTGGTGTCTCACGGT
GTATATTAGAACACATAGCC -> TATATTAGAACACATAGCCG
GTATCCGCTGGCAAGGGACA -> TATCCGCTGGCAAGGGACAT
GTATTCGAGAGGAGCAACCC -> TATTCGAGAGGAGCAACCCT
GTCAATTCGCCAATTGCGGG -> TCAATTCGCCAATTGCGGGT
GTCACATCTCTGCGTTTCTG -> TCACATCTCTGCGTTTCTGG
GTCACCACGGAGGCGGACCG -> TCACCACGGAGGCGGACCGG
GTCAGTTAGTTCAAGAGCTG -> TCAGTTAGTTCAAGAGCTGA
GTCATACCAGTGGCTTGTCG -> TCATACCAGTGGCTTGTCGT
GTCATTCTGTTCTCTCTAAC -> TCATTCTGTTCTCTCTAACT
GTCATTGATATAAAACTTTA -> TCATTGATATAAAACTTTAA
GTCCAAAGCATGCGGGCGTG -> TCCAAAGCATGCGGGCGTGG
GTCCACTTGGTACCTCCTAA -> TCCACTTGGTACCTCCTAAA
GTCCAGACAAGAGGATGGTT -> TCCAGACAAGAGGATGGTTC
GTCCCAAACGAATGCACAGA -> TCCCAAACGAATGCACAGAA
GTCCCGGGCGAGGCAGCTTG -> TCCCGGGCGAGGCAGCTTGC
GTCCCGTGCCAATGTGATTC -> TCCCGTGCCAATGTGATTCG
GTCCGGCCCGGCTATATAAT -> TCCGGCCCGGCTATATAATG
GTCGATTAGTCCACTTGGTA -> TCGATTAGTCCACTTGGTAC
GTCGGTATATTAGAACACAT -> TCGGTATATTAGAACACATA
GTCGTCCAAAGCATGCGGGC -> TCGTCCAAAGCATGCGGGCG
GTCGTTACCCAACTGCGTGT -> TCGTTACCCAACTGCGTGTT
GTCGTTCCGGTCATACCAGT -> TCGTTCCGGTCATACCAGTG
GTCTCACGGTACGGTCAATT -> TCTCACGGTACGGTCAATTC
GTCTCATTGCCGGAGCTGGC -> TCTCATTGCCGGAGCTGGCC
GTGAGACCGCTAGGGGTTCT -> TGAGACCGCTAGGGGTTCTA
GTGATACTGGATTTACCTGG -> TGATACTGGATTTACCTGGC
GTGATTCGAGTCACATCTCT -> TGATTCGAGTCACATCTCTG
GTGCCAATGTGATTCGAGTC -> TGCCAATGTGATTCGAGTCA
GTGCCTGGACGAGGGTCCCA -> TGCCTGGACGAGGGTCCCAA
GTGCCTGTCGTCCAAAGCAT -> TGCCTGTCGTCCAAAGCATG
GTGCGATGGGCCGGGTTCTA -> TGCGATGGGCCGGGTTCTAT
GTGCTCGGGTTAGGGATCAC -> TGCTCGGGTTAGGGATCACA
GTGCTGCAGATAGACTGAAA -> TGCTGCAGATAGACTGAAAT
GTGGAGAAACTGAAGCACTC -> TGGAGAAACTGAAGCACTCC
GTGGATGTGCTCGGGTTAGG -> TGGATGTGCTCGGGTTAGGG
GTGGCTTGTCGTTACCCAAC -> TGGCTTGTCGTTACCCAACT
GTGTCCCGGGCGAGGCAGCT -> TGTCCCGGGCGAGGCAGCTT
GTGTCTCACGGTACGGTCAA -> TGTCTCACGGTACGGTCAAT
GTGTTCAGGTGCGATGGGCC -> TGTTCAGGTGCGATGGGCCG
GTGTTGGGCAGTCACCACGG -> TGTTGGGCAGTCACCACGGA
GTTACATCCCGTAGTTCTGG -> TTACATCCCGTAGTTCTGGT
GTTACCCAACTGCGTGTTGG -> TTACCCAACTGCGTGTTGGG
GTTAGGGATCACATACCCTT -> TTAGGGATCACATACCCTTA
GTTAGTTCAAGAGCTGAAAG -> TTAGTTCAAGAGCTGAAAGC
GTTCAAGAGCTGAAAGCAAT -> TTCAAGAGCTGAAAGCAATA
GTTCAGGTGCGATGGGCCGG -> TTCAGGTGCGATGGGCCGGG
GTTCCCTTGTTACATCCCGT -> TTCCCTTGTTACATCCCGTA
GTTCCGGTCATACCAGTGGC -> TTCCGGTCATACCAGTGGCT
GTTCGTCGGTATATTAGAAC -> TTCGTCGGTATATTAGAACA
GTTCTATACGAATACAGCCG -> TTCTATACGAATACAGCCGA
GTTCTATTGGACGTAACGTG -> TTCTATTGGACGTAACGTGT
GTTCTCTCTAACTCCAACAA -> TTCTCTCTAACTCCAACAAC
GTTCTGGTGTCTCACGGTAC -> TTCTGGTGTCTCACGGTACG
GTTGGGCAGTCACCACGGAG -> TTGGGCAGTCACCACGGAGG
GTTTCTAGTCCGGCCCGGCT -> TTTCTAGTCCGGCCCGGCTA
GTTTCTGGGTAATATTCATT -> TTTCTGGGTAATATTCATTT
GTTTGACTGTATCCGCTGGC -> TTTGACTGTATCCGCTGGCA
GTTTTCATAGAGTGTTCAGG -> TTTTCATAGAGTGTTCAGGT
TAAAACTTTAAAATAACCAA -> AAAACTTTAAAATAACCAAA
TAAAATAACCAAATTAAGTC -> AAAATAACCAAATTAAGTCA
TAAAGGGTCATTGATATAAA -> AAAGGGTCATTGATATAAAA
TAACCAAATTAAGTCATTCT -> AACCAAATTAAGTCATTCTG
TAACGCGCTGATCCGGGCCG -> AACGCGCTGATCCGGGCCGT
TAACGGCAAATATACGTTTC -> AACGGCAAATATACGTTTCT
TAACGTGTCCCGGGCGAGGC -> AACGTGTCCCGGGCGAGGCA
TAACTCCAACAACGGTGGAG -> AACTCCAACAACGGTGGAGA
TAAGTCATTCTGTTCTCTCT -> AAGTCATTCTGTTCTCTCTA
TAATATTCATTTCTTGATTA -> AATATTCATTTCTTGATTAG
TAATGCGAGCCTATCCAGCG -> AATGCGAGCCTATCCAGCGT
TAATTGTGCTGCAGATAGAC -> AATTGTGCTGCAGATAGACT
TACATCCCGTAGTTCTGGTG -> ACATCCCGTAGTTCTGGTGT
TACCACACGCGAGAGCTGGC -> ACCACACGCGAGAGCTGGCG
TACCAGTGGCTTGTCGTTAC -> ACCAGTGGCTTGTCGTTACC
TACCCAACTGCGTGTTGGGC -> ACCCAACTGCGTGTTGGGCA
TACCCTTATGAACGTAGCCT -> ACCCTTATGAACGTAGCCTA
TACCGCAAACACGTGCCTGG -> ACCGCAAACACGTGCCTGGA
TACCTACCGCAAACACGTGC -> ACCTACCGCAAACACGTGCC
TACCTCCTAAAGGGTCATTG -> ACCTCCTAAAGGGTCATTGA
TACCTGGCTGGCCCACGATG -> ACCTGGCTGGCCCACGATGT
TACGATTATTACCACACGCG -> ACGATTATTACCACACGCGA
TACGGTCAATTCGCCAATTG -> ACGGTCAATTCGCCAATTGC
TACGTACGATTATTACCACA -> ACGTACGATTATTACCACAC
TACGTTTCTAGTCCGGCCCG -> ACGTTTCTAGTCCGGCCCGG
TACTGGATTTACCTGGCTGG -> ACTGGATTTACCTGGCTGGC
TAGAACACATAGCCGAAGGT -> AGAACACATAGCCGAAGGTA
TAGACTGAAATTATAGGAGG -> AGACTGAAATTATAGGAGGT
TAGAGTGTTCAGGTGCGATG -> AGAGTGTTCAGGTGCGATGG
TAGCCGAAGGTACGTACGAT -> AGCCGAAGGTACGTACGATT
TAGCCTATATTGGCTGCGTG -> AGCCTATATTGGCTGCGTGA
TAGCCTCACCTGGATTGTAA -> AGCCTCACCTGGATTGTAAC
TAGGAGGTATTCGAGAGGAG -> AGGAGGTATTCGAGAGGAGC
TAGGCGAGTGCCTGTCGTCC -> AGGCGAGTGCCTGTCGTCCA
TAGGGATCACATACCCTTAT -> AGGGATCACATACCCTTATG
TAGGGGTTCTATTGGACGTA -> AGGGGTTCTATTGGACGTAA
TAGGTCCAGACAAGAGGATG -> AGGTCCAGACAAGAGGATGG
TAGTCCACTTGGTACCTCCT -> AGTCCACTTGGTACCTCCTA
TAGTCCGGCCCGGCTATATA -> AGTCCGGCCCGGCTATATAA
TAGTTCAAGAGCTGAAAGCA -> AGTTCAAGAGCTGAAAGCAA
TAGTTCTGGTGTCTCACGGT -> AGTTCTGGTGTCTCACGGTA
TATAAAACTTTAAAATAACC -> ATAAAACTTTAAAATAACCA
TATAATGCGAGCCTATCCAG -> ATAATGCGAGCCTATCCAGC
TATACGTTTCTAGTCCGGCC -> ATACGTTTCTAGTCCGGCCC
TATAGGAGGTATTCGAGAGG -> ATAGGAGGTATTCGAGAGGA
TATAGGTCCAGACAAGAGGA -> ATAGGTCCAGACAAGAGGAT
TATATAATGCGAGCCTATCC -> ATATAATGCGAGCCTATCCA
TATATAGGTCCAGACAAGAG -> ATATAGGTCCAGACAAGAGG
TATATTAGAACACATAGCCG -> ATATTAGAACACATAGCCGA
TATATTGGCTGCGTGAGACC -> ATATTGGCTGCGTGAGACCG
TATCCAGCGTCGTTCCGGTC -> ATCCAGCGTCGTTCCGGTCA
TATCCGCTGGCAAGGGACAT -> ATCCGCTGGCAAGGGACATG
TATCGCGGAGGTGATACTGG -> ATCGCGGAGGTGATACTGGA
TATGAACGTAGCCTATATTG -> ATGAACGTAGCCTATATTGG
TATGAATCCTTAATTGTGCT -> ATGAATCCTTAATTGTGCTG
TATTACCACACGCGAGAGCT -> ATTACCACACGCGAGAGCTG
TATTAGAACACATAGCCGAA -> ATTAGAACACATAGCCGAAG
TATTCATTTCTTGATTAGCC -> ATTCATTTCTTGATTAGCCT
TATTCGAGAGGAGCAACCCT -> ATTCGAGAGGAGCAACCCTC
TATTGGACGTAACGTGTCCC -> ATTGGACGTAACGTGTCCCG
TATTGGCTGCGTGAGACCGC -> ATTGGCTGCGTGAGACCGCT
TCAAGAGCTGAAAGCAATAT -> CAAGAGCTGAAAGCAATATG
TCAAGGAATATATAGGTCCA -> CAAGGAATATATAGGTCCAG
TCAATGCCGTCCCGTGCCAA -> CAATGCCGTCCCGTGCCAAT
TCAATTCGCCAATTGCGGGT -> CAATTCGCCAATTGCGGGTC
TCACATACCCTTATGAACGT -> CACATACCCTTATGAACGTA
TCACATCTCTGCGTTTCTGG -> CACATCTCTGCGTTTCTGGG
TCACCACGGAGGCGGACCGG -> CACCACGGAGGCGGACCGGA
TCACCTGGATTGTAACGGCA -> CACCTGGATTGTAACGGCAA
TCACGGTACGGTCAATTCGC -> CACGGTACGGTCAATTCGCC
TCAGGTGCGATGGGCCGGGT -> CAGGTGCGATGGGCCGGGTT
TCAGTCGATTAGTCCACTTG -> CAGTCGATTAGTCCACTTGG
TCAGTTAGTTCAAGAGCTGA -> CAGTTAGTTCAAGAGCTGAA
TCATACCAGTGGCTTGTCGT -> CATACCAGTGGCTTGTCGTT
TCATAGAGTGTTCAGGTGCG -> CATAGAGTGTTCAGGTGCGA
TCATTCTGTTCTCTCTAACT -> CATTCTGTTCTCTCTAACTC
TCATTGATATAAAACTTTAA -> CATTGATATAAAACTTTAAA
TCATTGCCGGAGCTGGCCAC -> CATTGCCGGAGCTGGCCACC
TCATTTCTTGATTAGCCTCA -> CATTTCTTGATTAGCCTCAC
TCCAAAGCATGCGGGCGTGG -> CCAAAGCATGCGGGCGTGGA
TCCAACAACGGTGGAGAAAC -> CCAACAACGGTGGAGAAACT
TCCACTTGGTACCTCCTAAA -> CCACTTGGTACCTCCTAAAG
TCCAGACAAGAGGATGGTTC -> CCAGACAAGAGGATGGTTCG
TCCAGCGTCGTTCCGGTCAT -> CCAGCGTCGTTCCGGTCATA
TCCCAAACGAATGCACAGAA -> CCCAAACGAATGCACAGAAC
TCCCAACATGTTTTCATAGA -> CCCAACATGTTTTCATAGAG
TCCCGGGCGAGGCAGCTTGC -> CCCGGGCGAGGCAGCTTGCT
TCCCGTAGTTCTGGTGTCTC -> CCCGTAGTTCTGGTGTCTCA
TCCCGTGCCAATGTGATTCG -> CCCGTGCCAATGTGATTCGA
TCCCTTGTTACATCCCGTAG -> CCCTTGTTACATCCCGTAGT
TCCGCTGGCAAGGGACATGG -> CCGCTGGCAAGGGACATGGA
TCCGGCCCGGCTATATAATG -> CCGGCCCGGCTATATAATGC
TCCGGGCCGTTTGACTGTAT -> CCGGGCCGTTTGACTGTATC
TCCGGTCATACCAGTGGCTT -> CCGGTCATACCAGTGGCTTG
TCCTAAAGGGTCATTGATAT -> CCTAAAGGGTCATTGATATA
TCCTTAATTGTGCTGCAGAT -> CCTTAATTGTGCTGCAGATA
TCGAGAGGAGCAACCCTCAG -> CGAGAGGAGCAACCCTCAGT
TCGAGTCACATCTCTGCGTT -> CGAGTCACATCTCTGCGTTT
TCGATTAGTCCACTTGGTAC -> CGATTAGTCCACTTGGTACC
TCGCCAATTGCGGGTCAGTT -> CGCCAATTGCGGGTCAGTTA
TCGCGGAGGTGATACTGGAT -> CGCGGAGGTGATACTGGATT
TCGGGTTAGGGATCACATAC -> CGGGTTAGGGATCACATACC
TCGGTATATTAGAACACATA -> CGGTATATTAGAACACATAG
TCGTAACGCGCTGATCCGGG -> CGTAACGCGCTGATCCGGGC
TCGTCCAAAGCATGCGGGCG -> CGTCCAAAGCATGCGGGCGT
TCGTCGGTATATTAGAACAC -> CGTCGGTATATTAGAACACA
TCGTTACCCAACTGCGTGTT -> CGTTACCCAACTGCGTGTTG
TCGTTCCGGTCATACCAGTG -> CGTTCCGGTCATACCAGTGG
TCTAACTCCAACAACGGTGG -> CTAACTCCAACAACGGTGGA
TCTAGTCCGGCCCGGCTATA -> CTAGTCCGGCCCGGCTATAT
TCTATTGGACGTAACGTGTC -> CTATTGGACGTAACGTGTCC
TCTCACGGTACGGTCAATTC -> CTCACGGTACGGTCAATTCG
TCTCATTGCCGGAGCTGGCC -> CTCATTGCCGGAGCTGGCCA
TCTCTAACTCCAACAACGGT -> CTCTAACTCCAACAACGGTG
TCTCTCTAACTCCAACAACG -> CTCTCTAACTCCAACAACGG
TCTCTGCGTTTCTGGGTAAT -> CTCTGCGTTTCTGGGTAATA
TCTCTTCAATGCCGTCCCGT -> CTCTTCAATGCCGTCCCGTG
TCTGCGTTTCTGGGTAATAT -> CTGCGTTTCTGGGTAATATT
TCTGGGTAATATTCATTTCT -> CTGGGTAATATTCATTTCTT
TCTGGTGTCTCACGGTACGG -> CTGGTGTCTCACGGTACGGT
TCTGTTCTCTCTAACTCCAA -> CTGTTCTCTCTAACTCCAAC
TCTTCAATGCCGTCCCGTGC -> CTTCAATGCCGTCCCGTGCC
TCTTGATTAGCCTCACCTGG -> CTTGATTAGCCTCACCTGGA
TGAAAGCAATATGAATCCTT -> GAAAGCAATATGAATCCTTA
TGAAATTATAGGAGGTATTC -> GAAATTATAGGAGGTATTCG
TGAACGTAGCCTATATTGGC -> GAACGTAGCCTATATTGGCT
TGAAGCACTCCCAACATGTT -> GAAGCACTCCCAACATGTTT
TGAATCCTTAATTGTGCTGC -> GAATCCTTAATTGTGCTGCA
TGACGCCACAATATCGCGGA -> GACGCCACAATATCGCGGAG
TGACTGTATCCGCTGGCAAG -> GACTGTATCCGCTGGCAAGG
TGAGACCGCTAGGGGTTCTA -> GAGACCGCTAGGGGTTCTAT
TGATACTGGATTTACCTGGC -> GATACTGGATTTACCTGGCT
TGATATAAAACTTTAAAATA -> GATATAAAACTTTAAAATAA
TGATCCGGGCCGTTTGACTG -> GATCCGGGCCGTTTGACTGT
TGATTAGCCTCACCTGGATT -> GATTAGCCTCACCTGGATTG
TGATTCGAGTCACATCTCTG -> GATTCGAGTCACATCTCTGC
TGCACAGAACAGGCTCAAGG -> GCACAGAACAGGCTCAAGGA
TGCAGATAGACTGAAATTAT -> GCAGATAGACTGAAATTATA
TGCCAATGTGATTCGAGTCA -> GCCAATGTGATTCGAGTCAC
TGCCGGAGCTGGCCACCGTA -> GCCGGAGCTGGCCACCGTAG
TGCCGTCCCGTGCCAATGTG -> GCCGTCCCGTGCCAATGTGA
TGCCTGGACGAGGGTCCCAA -> GCCTGGACGAGGGTCCCAAA
TGCCTGTCGTCCAAAGCATG -> GCCTGTCGTCCAAAGCATGC
TGCGAGCCTATCCAGCGTCG -> GCGAGCCTATCCAGCGTCGT
TGCGATGGGCCGGGTTCTAT -> GCGATGGGCCGGGTTCTATA
TGCGGGCGTGGATGTGCTCG -> GCGGGCGTGGATGTGCTCGG
TGCGGGTCAGTTAGTTCAAG -> GCGGGTCAGTTAGTTCAAGA
TGCGTGAGACCGCTAGGGGT -> GCGTGAGACCGCTAGGGGTT
TGCGTGTTGGGCAGTCACCA -> GCGTGTTGGGCAGTCACCAC
TGCGTTTCTGGGTAATATTC -> GCGTTTCTGGGTAATATTCA
TGCTCGGGTTAGGGATCACA -> GCTCGGGTTAGGGATCACAT
TGCTGCAGATAGACTGAAAT -> GCTGCAGATAGACTGAAATT
TGCTTGACGCCACAATATCG -> GCTTGACGCCACAATATCGC
TGGACGAGGGTCCCAAACGA -> GGACGAGGGTCCCAAACGAA
TGGACGTAACGTGTCCCGGG -> GGACGTAACGTGTCCCGGGC
TGGAGAAACTGAAGCACTCC -> GGAGAAACTGAAGCACTCCC
TGGAGTACCTACCGCAAACA -> GGAGTACCTACCGCAAACAC
TGGATGTGCTCGGGTTAGGG -> GGATGTGCTCGGGTTAGGGA
TGGATTGTAACGGCAAATAT -> GGATTGTAACGGCAAATATA
TGGATTTACCTGGCTGGCCC -> GGATTTACCTGGCTGGCCCA
TGGCAAGGGACATGGAGTAC -> GGCAAGGGACATGGAGTACC
TGGCCACCGTAGGCGAGTGC -> GGCCACCGTAGGCGAGTGCC
TGGCCCACGATGTTCCCTTG -> GGCCCACGATGTTCCCTTGT
TGGCGGCCTTGTCTCATTGC -> GGCGGCCTTGTCTCATTGCC
TGGCTGCGTGAGACCGCTAG -> GGCTGCGTGAGACCGCTAGG
TGGCTGGCCCACGATGTTCC -> GGCTGGCCCACGATGTTCCC
TGGCTTGTCGTTACCCAACT -> GGCTTGTCGTTACCCAACTG
TGGGCAGTCACCACGGAGGC -> GGGCAGTCACCACGGAGGCG
TGGGCCGGGTTCTATACGAA -> GGGCCGGGTTCTATACGAAT
TGGGTAATATTCATTTCTTG -> GGGTAATATTCATTTCTTGA
TGGTACCTCCTAAAGGGTCA -> GGTACCTCCTAAAGGGTCAT
TGGTGTCTCACGGTACGGTC -> GGTGTCTCACGGTACGGTCA
TGGTTCGTCGGTATATTAGA -> GGTTCGTCGGTATATTAGAA
TGTAACGGCAAATATACGTT -> GTAACGGCAAATATACGTTT
TGTATCCGCTGGCAAGGGAC -> GTATCCGCTGGCAAGGGACA
TGTCCCGGGCGAGGCAGCTT -> GTCCCGGGCGAGGCAGCTTG
TGTCGTCCAAAGCATGCGGG -> GTCGTCCAAAGCATGCGGGC
TGTCGTTACCCAACTGCGTG -> GTCGTTACCCAACTGCGTGT
TGTCTCACGGTACGGTCAAT -> GTCTCACGGTACGGTCAATT
TGTCTCATTGCCGGAGCTGG -> GTCTCATTGCCGGAGCTGGC
TGTGATTCGAGTCACATCTC -> GTGATTCGAGTCACATCTCT
TGTGCTCGGGTTAGGGATCA -> GTGCTCGGGTTAGGGATCAC
TGTGCTGCAGATAGACTGAA -> GTGCTGCAGATAGACTGAAA
TGTTACATCCCGTAGTTCTG -> GTTACATCCCGTAGTTCTGG
TGTTCAGGTGCGATGGGCCG -> GTTCAGGTGCGATGGGCCGG
TGTTCCCTTGTTACATCCCG -> GTTCCCTTGTTACATCCCGT
TGTTCTCTCTAACTCCAACA -> GTTCTCTCTAACTCCAACAA
TGTTGGGCAGTCACCACGGA -> GTTGGGCAGTCACCACGGAG
TGTTTTCATAGAGTGTTCAG -> GTTTTCATAGAGTGTTCAGG
TTAAAATAACCAAATTAAGT -> TAAAATAACCAAATTAAGTC
TTAAGTCATTCTGTTCTCTC -> TAAGTCATTCTGTTCTCTCT
TTAATTGTGCTGCAGATAGA -> TAATTGTGCTGCAGATAGAC
TTACATCCCGTAGTTCTGGT -> TACATCCCGTAGTTCTGGTG
TTACCACACGCGAGAGCTGG -> TACCACACGCGAGAGCTGGC
TTACCCAACTGCGTGTTGGG -> TACCCAACTGCGTGTTGGGC
TTACCTGGCTGGCCCACGAT -> TACCTGGCTGGCCCACGATG
TTAGAACACATAGCCGAAGG -> TAGAACACATAGCCGAAGGT
TTAGCCTCACCTGGATTGTA -> TAGCCTCACCTGGATTGTAA
TTAGGGATCACATACCCTTA -> TAGGGATCACATACCCTTAT
TTAGTCCACTTGGTACCTCC -> TAGTCCACTTGGTACCTCCT
TTAGTTCAAGAGCTGAAAGC -> TAGTTCAAGAGCTGAAAGCA
TTATAGGAGGTATTCGAGAG -> TATAGGAGGTATTCGAGAGG
TTATGAACGTAGCCTATATT -> TATGAACGTAGCCTATATTG
TTATTACCACACGCGAGAGC -> TATTACCACACGCGAGAGCT
TTCAAGAGCTGAAAGCAATA -> TCAAGAGCTGAAAGCAATAT
TTCAATGCCGTCCCGTGCCA -> TCAATGCCGTCCCGTGCCAA
TTCAGGTGCGATGGGCCGGG -> TCAGGTGCGATGGGCCGGGT
TTCATAGAGTGTTCAGGTGC -> TCATAGAGTGTTCAGGTGCG
TTCATTTCTTGATTAGCCTC -> TCATTTCTTGATTAGCCTCA
TTCCCTTGTTACATCCCGTA -> TCCCTTGTTACATCCCGTAG
TTCCGGTCATACCAGTGGCT -> TCCGGTCATACCAGTGGCTT
TTCGAGAGGAGCAACCCTCA -> TCGAGAGGAGCAACCCTCAG
TTCGAGTCACATCTCTGCGT -> TCGAGTCACATCTCTGCGTT
TTCGCCAATTGCGGGTCAGT -> TCGCCAATTGCGGGTCAGTT
TTCGTCGGTATATTAGAACA -> TCGTCGGTATATTAGAACAC
TTCTAGTCCGGCCCGGCTAT -> TCTAGTCCGGCCCGGCTATA
TTCTATTGGACGTAACGTGT -> TCTATTGGACGTAACGTGTC
TTCTCTCTAACTCCAACAAC -> TCTCTCTAACTCCAACAACG
TTCTCTTCAATGCCGTCCCG -> TCTCTTCAATGCCGTCCCGT
TTCTGGGTAATATTCATTTC -> TCTGGGTAATATTCATTTCT
TTCTGGTGTCTCACGGTACG -> TCTGGTGTCTCACGGTACGG
TTCTGTTCTCTCTAACTCCA -> TCTGTTCTCTCTAACTCCAA
TTCTTGATTAGCCTCACCTG -> TCTTGATTAGCCTCACCTGG
TTGACGCCACAATATCGCGG -> TGACGCCACAATATCGCGGA
TTGACTGTATCCGCTGGCAA -> TGACTGTATCCGCTGGCAAG
TTGATATAAAACTTTAAAAT -> TGATATAAAACTTTAAAATA
TTGATTAGCCTCACCTGGAT -> TGATTAGCCTCACCTGGATT
TTGCCGGAGCTGGCCACCGT -> TGCCGGAGCTGGCCACCGTA
TTGCGGGTCAGTTAGTTCAA -> TGCGGGTCAGTTAGTTCAAG
TTGCTTGACGCCACAATATC -> TGCTTGACGCCACAATATCG
TTGGACGTAACGTGTCCCGG -> TGGACGTAACGTGTCCCGGG
TTGGCTGCGTGAGACCGCTA -> TGGCTGCGTGAGACCGCTAG
TTGGGCAGTCACCACGGAGG -> TGGGCAGTCACCACGGAGGC
TTGGTACCTCCTAAAGGGTC -> TGGTACCTCCTAAAGGGTCA
TTGTAACGGCAAATATACGT -> TGTAACGGCAAATATACGTT
TTGTCGTTACCCAACTGCGT -> TGTCGTTACCCAACTGCGTG
TTGTCTCATTGCCGGAGCTG -> TGTCTCATTGCCGGAGCTGG
TTGTGCTGCAGATAGACTGA -> TGTGCTGCAGATAGACTGAA
TTGTTACATCCCGTAGTTCT -> TGTTACATCCCGTAGTTCTG
TTTAAAATAACCAAATTAAG -> TTAAAATAACCAAATTAAGT
TTTACCTGGCTGGCCCACGA -> TTACCTGGCTGGCCCACGAT
TTTCATAGAGTGTTCAGGTG -> TTCATAGAGTGTTCAGGTGC
TTTCTAGTCCGGCCCGGCTA -> TTCTAGTCCGGCCCGGCTAT
TTTCTGGGTAATATTCATTT -> TTCTGGGTAATATTCATTTC
TTTCTTGATTAGCCTCACCT -> TTCTTGATTAGCCTCACCTG
TTTGACTGTATCCGCTGGCA -> TTGACTGTATCCGCTGGCAA
TTTTCATAGAGTGTTCAGGT -> TTTCATAGAGTGTTCAGGTG
