AAAAACAGCGA -> AAAACAGCGAC
AAAACAGCGAC -> AAACAGCGACT
AAAACCCCCCT -> AAACCCCCCTT
AAAACGAGATT -> AAACGAGATTA
AAAACGTCGAG -> AAACGTCGAGC
AAAACGTGCTG -> AAACGTGCTGC
AAAAGCACACG -> AAAGCACACGC
AAAATAAAGAG -> AAATAAAGAGG
AAAATCGCGTA -> AAATCGCGTAG
AAACAAGACAT -> AACAAGACATG
AAACACGTGAG -> AACACGTGAGA
AAACAGCGACT -> AACAGCGACTG
AAACCCCCCTT -> AACCCCCCTTA
AAACGAGATTA -> AACGAGATTAT
AAACGGCGATG -> AACGGCGATGT
AAACGTCGAGC -> AACGTCGAGCT
AAACGTGCTGC -> AACGTGCTGCA
AAACTGTTATG -> AACTGTTATGC
AAAGAGGGTAG -> AAGAGGGTAGA
AAAGCACACGC -> AAGCACACGCA
AAAGGCACTAG -> AAGGCACTAGC
AAAGTATCTAC -> AAGTATCTACT
AAATAAAGAGG -> AATAAAGAGGG
AAATACCTTCG -> AATACCTTCGG
AAATCAAGTTG -> AATCAAGTTGA
AAATCGCGTAG -> AATCGCGTAGT
AAATGGCCGTT -> AATGGCCGTTA
AAATGTCGGTC -> AATGTCGGTCG
AAATTATCTAG -> AATTATCTAGT
AACAACAGTTA -> ACAACAGTTAA
AACAACTCGGG -> ACAACTCGGGG
AACAAGACATG -> ACAAGACATGA
AACAATATTCG -> ACAATATTCGG
AACAATTATGA -> ACAATTATGAT
AACACGTGAGA -> ACACGTGAGAC
AACACTGCACG -> ACACTGCACGA
AACAGCGACTG -> ACAGCGACTGT
AACAGTTAATA -> ACAGTTAATAT
AACATATCCAA -> ACATATCCAAC
AACATCCAAGT -> ACATCCAAGTT
AACCCAGACGG -> ACCCAGACGGT
AACCCCCCTTA -> ACCCCCCTTAC
AACCGCCGGTG -> ACCGCCGGTGA
AACCGGTGTGG -> ACCGGTGTGGA
AACCTTTTCTA -> ACCTTTTCTAC
AACGAAGGGTC -> ACGAAGGGTCG
AACGACTCGAG -> ACGACTCGAGT
AACGAGATTAT -> ACGAGATTATA
AACGCTGTAAC -> ACGCTGTAACC
AACGCTGTTCT -> ACGCTGTTCTG
AACGGCGATGT -> ACGGCGATGTT
AACGGGCGTTC -> ACGGGCGTTCA
AACGTAACTGC -> ACGTAACTGCT
AACGTCGAGCT -> ACGTCGAGCTC
AACGTGCTGCA -> ACGTGCTGCAA
AACTCCTCACG -> ACTCCTCACGT
AACTCGGGGGG -> ACTCGGGGGGG
AACTGAGGGGT -> ACTGAGGGGTG
AACTGAGTACA -> ACTGAGTACAA
AACTGCTATCC -> ACTGCTATCCG
AACTGTAGCAC -> ACTGTAGCACG
AACTGTTATGC -> ACTGTTATGCT
AACTTGCAAGA -> ACTTGCAAGAC
AAGAACTTGCA -> AGAACTTGCAA
AAGACAGACCA -> AGACAGACCAA
AAGACATGATG -> AGACATGATGA
AAGACCCGGAT -> AGACCCGGATA
AAGACCGCGTG -> AGACCGCGTGT
AAGAGAGGACG -> AGAGAGGACGT
AAGAGGGTAGA -> AGAGGGTAGAC
AAGAGTTGCAC -> AGAGTTGCACT
AAGATTTCGTG -> AGATTTCGTGA
AAGCACACGCA -> AGCACACGCAG
AAGCACCGCGA -> AGCACCGCGAC
AAGCCATTCGC -> AGCCATTCGCT
AAGCCCTAGTT -> AGCCCTAGTTG
AAGCCTGAAGA -> AGCCTGAAGAG
AAGGCACTAGC -> AGGCACTAGCC
AAGGGAGACCC -> AGGGAGACCCG
AAGGGGCGGGT -> AGGGGCGGGTT
AAGGGTCGTTG -> AGGGTCGTTGG
AAGTAACAACT -> AGTAACAACTC
AAGTAGTGAAC -> AGTAGTGAACA
AAGTATCTACT -> AGTATCTACTA
AAGTGCCAGTG -> AGTGCCAGTGT
AAGTGGCAAGA -> AGTGGCAAGAC
AAGTTCCTTAA -> AGTTCCTTAAT
AAGTTGAAACA -> AGTTGAAACAA
AATAAACTGTT -> ATAAACTGTTA
AATAAAGAGGG -> ATAAAGAGGGT
AATACATGTAA -> ATACATGTAAA
AATACCTTCGG -> ATACCTTCGGT
AATATCATAGT -> ATATCATAGTG
AATATTAGCGT -> ATATTAGCGTG
AATATTCGGCA -> ATATTCGGCAG
AATCAAGTTGA -> ATCAAGTTGAA
AATCACGACAT -> ATCACGACATC
AATCAGTCCTA -> ATCAGTCCTAC
AATCGCGTAGT -> ATCGCGTAGTA
AATGAGCAGGT -> ATGAGCAGGTC
AATGCGAATTA -> ATGCGAATTAC
AATGGAGTATC -> ATGGAGTATCC
AATGGCCGTTA -> ATGGCCGTTAA
AATGTCGGTCG -> ATGTCGGTCGC
AATTACAGATG -> ATTACAGATGA
AATTAGCTTCT -> ATTAGCTTCTG
AATTATCTAGT -> ATTATCTAGTT
AATTATGATAA -> ATTATGATAAA
AATTCCAACTG -> ATTCCAACTGT
AATTTCAGTCA -> ATTTCAGTCAC
ACAAAACGTGC -> CAAAACGTGCT
ACAAAATCGCG -> CAAAATCGCGT
ACAACAGTTAA -> CAACAGTTAAT
ACAACTCGGGG -> CAACTCGGGGG
ACAACTGAGTA -> CAACTGAGTAC
ACAAGACATGA -> CAAGACATGAT
ACAAGAGTTGC -> CAAGAGTTGCA
ACAAGCCTGAA -> CAAGCCTGAAG
ACAAGGGAGAC -> CAAGGGAGACC
ACAATATTCGG -> CAATATTCGGC
ACAATGAGCAG -> CAATGAGCAGG
ACAATTATGAT -> CAATTATGATA
ACACAATGAGC -> CACAATGAGCA
ACACATCGGAT -> CACATCGGATT
ACACGCAGCAG -> CACGCAGCAGG
ACACGTGAGAC -> CACGTGAGACT
ACACTACATTT -> CACTACATTTG
ACACTGCACGA -> CACTGCACGAC
ACAGACCAAAA -> CAGACCAAAAA
ACAGATGAATA -> CAGATGAATAT
ACAGCGACTGT -> CAGCGACTGTT
ACAGCTACCTC -> CAGCTACCTCT
ACAGGAGTTCA -> CAGGAGTTCAA
ACAGGCCGCTA -> CAGGCCGCTAT
ACAGGTCGACT -> CAGGTCGACTT
ACAGTGTCTTA -> CAGTGTCTTAT
ACAGTTAATAT -> CAGTTAATATT
ACATAGGTACA -> CATAGGTACAA
ACATATCCAAC -> CATATCCAACG
ACATATCGTCG -> CATATCGTCGA
ACATCCAAGTT -> CATCCAAGTTC
ACATCGCACTG -> CATCGCACTGA
ACATCGGATTG -> CATCGGATTGC
ACATGATGAAT -> CATGATGAATG
ACATGCCAGGG -> CATGCCAGGGG
ACATGTAAATT -> CATGTAAATTA
ACATTAAATAC -> CATTAAATACC
ACATTTACAGG -> CATTTACAGGA
ACATTTGAGCG -> CATTTGAGCGA
ACATTTGGCAC -> CATTTGGCACT
ACCAAAAACAG -> CCAAAAACAGC
ACCAAATGGCC -> CCAAATGGCCG
ACCAAGCACCG -> CCAAGCACCGC
ACCACTACACA -> CCACTACACAT
ACCAGGATATA -> CCAGGATATAT
ACCCAGACGGT -> CCCAGACGGTG
ACCCCACCGTA -> CCCCACCGTAG
ACCCCCCTTAC -> CCCCCCTTACG
ACCCGACGTCG -> CCCGACGTCGT
ACCCGCGGCGG -> CCCGCGGCGGT
ACCCGGATACC -> CCCGGATACCC
ACCGCCGGTGA -> CCGCCGGTGAG
ACCGCGACTTT -> CCGCGACTTTC
ACCGCGTGTTG -> CCGCGTGTTGT
ACCGCTGTTAT -> CCGCTGTTATT
ACCGGGGTACT -> CCGGGGTACTA
ACCGGTGTGGA -> CCGGTGTGGAG
ACCGTAGCTAT -> CCGTAGCTATT
ACCGTCGGGTC -> CCGTCGGGTCT
ACCGTTGGGCG -> CCGTTGGGCGC
ACCTCACTTTT -> CCTCACTTTTC
ACCTCCACGCC -> CCTCCACGCCA
ACCTCTCCTTA -> CCTCTCCTTAG
ACCTTCGGTCA -> CCTTCGGTCAA
ACCTTTTCTAC -> CCTTTTCTACC
ACGAAGGGTCG -> CGAAGGGTCGT
ACGACAAGAGT -> CGACAAGAGTT
ACGACATCGCA -> CGACATCGCAC
ACGACGCTGGG -> CGACGCTGGGT
ACGACTCATGT -> CGACTCATGTC
ACGACTCCGCG -> CGACTCCGCGC
ACGACTCGAGT -> CGACTCGAGTC
ACGAGATTATA -> CGAGATTATAC
ACGCACACAAT -> CGCACACAATG
ACGCAGCAGGG -> CGCAGCAGGGA
ACGCCACTTTC -> CGCCACTTTCG
ACGCCAGAGGA -> CGCCAGAGGAG
ACGCCCCGAAG -> CGCCCCGAAGT
ACGCCCCGCTT -> CGCCCCGCTTG
ACGCGACATAT -> CGCGACATATC
ACGCTGGGTGA -> CGCTGGGTGAT
ACGCTGTAACC -> CGCTGTAACCG
ACGCTGTTCTG -> CGCTGTTCTGG
ACGGAGTCGAC -> CGGAGTCGACA
ACGGCGATGTT -> CGGCGATGTTG
ACGGGCGTTCA -> CGGGCGTTCAA
ACGGTGGTGTA -> CGGTGGTGTAC
ACGTAACGACT -> CGTAACGACTC
ACGTAACTGCT -> CGTAACTGCTA
ACGTCGAGCTC -> CGTCGAGCTCT
ACGTCGTAACT -> CGTCGTAACTG
ACGTGAGACTC -> CGTGAGACTCC
ACGTGCTGCAA -> CGTGCTGCAAC
ACGTGTCTCTT -> CGTGTCTCTTC
ACGTTAGGTAG -> CGTTAGGTAGG
ACGTTATAGCT -> CGTTATAGCTT
ACGTTGAGGGT -> CGTTGAGGGTA
ACTAACTCCTC -> CTAACTCCTCA
ACTAATACATG -> CTAATACATGT
ACTACACATCG -> CTACACATCGG
ACTACATTTGA -> CTACATTTGAG
ACTACTAACTC -> CTACTAACTCC
ACTAGCAGCCG -> CTAGCAGCCGA
ACTAGCCGGGG -> CTAGCCGGGGG
ACTATGTTGTA -> CTATGTTGTAG
ACTCATGTCCT -> CTCATGTCCTT
ACTCCCCCACA -> CTCCCCCACAT
ACTCCGCGCGC -> CTCCGCGCGCG
ACTCCTCACGT -> CTCCTCACGTT
ACTCGAGTCTT -> CTCGAGTCTTG
ACTCGGGGGGG -> CTCGGGGGGGA
ACTGAGGGGTG -> CTGAGGGGTGG
ACTGAGTACAA -> CTGAGTACAAA
ACTGAGTTGAG -> CTGAGTTGAGC
ACTGCACGACT -> CTGCACGACTC
ACTGCTATCCG -> CTGCTATCCGT
ACTGGCATCGA -> CTGGCATCGAA
ACTGTAGATGC -> CTGTAGATGCA
ACTGTAGCACG -> CTGTAGCACGT
ACTGTTATGCT -> CTGTTATGCTT
ACTGTTCAGTT -> CTGTTCAGTTC
ACTTAACATAT -> CTTAACATATC
ACTTAAGCCAT -> CTTAAGCCATT
ACTTCTAGCGA -> CTTCTAGCGAA
ACTTCTCAGGG -> CTTCTCAGGGG
ACTTGCAAGAC -> CTTGCAAGACC
ACTTGCTCTCT -> CTTGCTCTCTA
ACTTGTTGTCC -> CTTGTTGTCCT
ACTTTCACAAG -> CTTTCACAAGC
ACTTTCGTCCC -> CTTTCGTCCCT
ACTTTTCGGTT -> CTTTTCGGTTT
ACTTTTCTTAC -> CTTTTCTTACT
AGAACATCCAA -> GAACATCCAAG
AGAACTTGCAA -> GAACTTGCAAG
AGACAGACCAA -> GACAGACCAAA
AGACATGATGA -> GACATGATGAA
AGACCAAAAAC -> GACCAAAAACA
AGACCAAATGG -> GACCAAATGGC
AGACCCGACGT -> GACCCGACGTC
AGACCCGGATA -> GACCCGGATAC
AGACCGCGTGT -> GACCGCGTGTT
AGACGCCCCGA -> GACGCCCCGAA
AGACGGTGGTG -> GACGGTGGTGT
AGACTCCCCCA -> GACTCCCCCAC
AGAGAGGACGT -> GAGAGGACGTA
AGAGGACGTAA -> GAGGACGTAAC
AGAGGAGTAGC -> GAGGAGTAGCG
AGAGGCCAATT -> GAGGCCAATTC
AGAGGGTAGAC -> GAGGGTAGACC
AGAGTCGGCCT -> GAGTCGGCCTG
AGAGTTGCACT -> GAGTTGCACTT
AGATAAAATAA -> GATAAAATAAA
AGATCCACGCC -> GATCCACGCCC
AGATGAATATC -> GATGAATATCA
AGATGCACAAG -> GATGCACAAGG
AGATTATACCA -> GATTATACCAG
AGATTTCGTGA -> GATTTCGTGAC
AGCACACGCAG -> GCACACGCAGC
AGCACCGCGAC -> GCACCGCGACT
AGCACGTTGAG -> GCACGTTGAGG
AGCAGCCGATT -> GCAGCCGATTC
AGCAGCCTCAC -> GCAGCCTCACC
AGCAGGGAACA -> GCAGGGAACAA
AGCAGGTCCAC -> GCAGGTCCACT
AGCATCGGTTT -> GCATCGGTTTC
AGCCATTCGCT -> GCCATTCGCTT
AGCCCTAGTTG -> GCCCTAGTTGG
AGCCGACAGGT -> GCCGACAGGTC
AGCCGATTCCA -> GCCGATTCCAA
AGCCGGGGGCC -> GCCGGGGGCCG
AGCCTCACCTC -> GCCTCACCTCC
AGCCTGAAGAG -> GCCTGAAGAGA
AGCGAACGCTG -> GCGAACGCTGT
AGCGAAGGGGC -> GCGAAGGGGCG
AGCGACTGTTC -> GCGACTGTTCA
AGCGGGTCCAG -> GCGGGTCCAGA
AGCGTGAAAAC -> GCGTGAAAACG
AGCTACCTCTC -> GCTACCTCTCC
AGCTATTTCCA -> GCTATTTCCAT
AGCTCTGATAA -> GCTCTGATAAC
AGCTGTCAAAC -> GCTGTCAAACG
AGCTGTTAATG -> GCTGTTAATGG
AGCTTCATTGT -> GCTTCATTGTC
AGCTTCTGGTG -> GCTTCTGGTGA
AGCTTTTCATG -> GCTTTTCATGA
AGGAAGTAGTG -> GGAAGTAGTGA
AGGACGTAACG -> GGACGTAACGA
AGGAGTAGCGG -> GGAGTAGCGGG
AGGAGTGTGAA -> GGAGTGTGAAG
AGGAGTTCAAG -> GGAGTTCAAGT
AGGATATATGC -> GGATATATGCG
AGGATTCTTCG -> GGATTCTTCGA
AGGCACTAGCC -> GGCACTAGCCG
AGGCCAATTCC -> GGCCAATTCCA
AGGCCGCTATG -> GGCCGCTATGC
AGGCTACTGGC -> GGCTACTGGCA
AGGGAACAATA -> GGGAACAATAT
AGGGAGACCCG -> GGGAGACCCGA
AGGGGCGGGTT -> GGGGCGGGTTA
AGGGGGAGGTC -> GGGGGAGGTCG
AGGGGTGGTCG -> GGGGTGGTCGC
AGGGGTTTTGC -> GGGGTTTTGCT
AGGGTAAATCA -> GGGTAAATCAA
AGGGTAGACCA -> GGGTAGACCAA
AGGGTCGTTGG -> GGGTCGTTGGT
AGGGTTCGATA -> GGGTTCGATAC
AGGGTTTTTGT -> GGGTTTTTGTT
AGGTACAACTG -> GGTACAACTGA
AGGTACCGCTG -> GGTACCGCTGT
AGGTAGGTCCT -> GGTAGGTCCTC
AGGTCCACTTC -> GGTCCACTTCT
AGGTCCTCGGT -> GGTCCTCGGTG
AGGTCGAATCA -> GGTCGAATCAC
AGGTCGACTTG -> GGTCGACTTGC
AGGTGGGCATG -> GGTGGGCATGC
AGTAACAACTC -> GTAACAACTCG
AGTAAGATTTC -> GTAAGATTTCG
AGTACAAAACG -> GTACAAAACGT
AGTAGCAGCCT -> GTAGCAGCCTC
AGTAGCGGGTC -> GTAGCGGGTCC
AGTAGTAAGAT -> GTAGTAAGATT
AGTAGTGAACA -> GTAGTGAACAC
AGTATCCCTAG -> GTATCCCTAGG
AGTATCCGCGT -> GTATCCGCGTT
AGTATCTACTA -> GTATCTACTAC
AGTATGCGTGC -> GTATGCGTGCG
AGTCACGACTC -> GTCACGACTCC
AGTCACTAGCA -> GTCACTAGCAG
AGTCCTACTTA -> GTCCTACTTAA
AGTCGACAAAA -> GTCGACAAAAT
AGTCGCGGTGG -> GTCGCGGTGGT
AGTCGGCCTGG -> GTCGGCCTGGC
AGTCGGGTTTT -> GTCGGGTTTTT
AGTCTTGCTCG -> GTCTTGCTCGA
AGTGAACACTG -> GTGAACACTGC
AGTGCCAGTGT -> GTGCCAGTGTC
AGTGCTAAGCC -> GTGCTAAGCCC
AGTGGCAAGAC -> GTGGCAAGACC
AGTGGCAGGCT -> GTGGCAGGCTA
AGTGGCTCAAC -> GTGGCTCAACC
AGTGGTTTTGG -> GTGGTTTTGGT
AGTGTCTATTG -> GTGTCTATTGT
AGTGTCTTATA -> GTGTCTTATAT
AGTGTGAAGAC -> GTGTGAAGACA
AGTTAATATTA -> GTTAATATTAG
AGTTCAAGTAA -> GTTCAAGTAAC
AGTTCCTTAAT -> GTTCCTTAATT
AGTTCTTGTCT -> GTTCTTGTCTT
AGTTGAAACAA -> GTTGAAACAAG
AGTTGAGCATC -> GTTGAGCATCG
AGTTGCACTTT -> GTTGCACTTTT
AGTTGGGAACG -> GTTGGGAACGG
AGTTGGTTACA -> GTTGGTTACAT
AGTTTAGCCGA -> GTTTAGCCGAC
AGTTTCTGGTA -> GTTTCTGGTAG
ATAAAATAAAG -> TAAAATAAAGA
ATAAACTGTTA -> TAAACTGTTAT
ATAAAGAGGGT -> TAAAGAGGGTA
ATAAAGGCACT -> TAAAGGCACTA
ATAACAACAGT -> TAACAACAGTT
ATAAGTGCCAG -> TAAGTGCCAGT
ATACATGTAAA -> TACATGTAAAT
ATACCAGGATA -> TACCAGGATAT
ATACCCCACCG -> TACCCCACCGT
ATACCTTCGGT -> TACCTTCGGTC
ATACGTTATAG -> TACGTTATAGC
ATAGAACATCC -> TAGAACATCCA
ATAGCTTCATT -> TAGCTTCATTG
ATAGCTTTTCA -> TAGCTTTTCAT
ATAGGTACAAC -> TAGGTACAACT
ATAGTCACGAC -> TAGTCACGACT
ATAGTGGCAGG -> TAGTGGCAGGC
ATATATGCGCC -> TATATGCGCCG
ATATCATAGTG -> TATCATAGTGG
ATATCCAACGT -> TATCCAACGTA
ATATCGTCGAT -> TATCGTCGATA
ATATGCGCCGT -> TATGCGCCGTG
ATATGCTACAC -> TATGCTACACT
ATATGTACGCA -> TATGTACGCAC
ATATTAGCGTG -> TATTAGCGTGA
ATATTCGGCAG -> TATTCGGCAGT
ATCAAGTTGAA -> TCAAGTTGAAA
ATCACGACATC -> TCACGACATCG
ATCAGTCCTAC -> TCAGTCCTACT
ATCAGTCGCGG -> TCAGTCGCGGT
ATCATAGTGGC -> TCATAGTGGCA
ATCCAACGTAA -> TCCAACGTAAC
ATCCAAGTTCC -> TCCAAGTTCCT
ATCCACGCCCC -> TCCACGCCCCG
ATCCCTAGGTG -> TCCCTAGGTGG
ATCCGCGTTCA -> TCCGCGTTCAT
ATCCGTGTCTT -> TCCGTGTCTTC
ATCCGTTGTAT -> TCCGTTGTATG
ATCGAATAAAC -> TCGAATAAACT
ATCGCACTGAG -> TCGCACTGAGT
ATCGCGTAGTA -> TCGCGTAGTAG
ATCGGATTGCC -> TCGGATTGCCT
ATCGGTTTCTA -> TCGGTTTCTAG
ATCGTCCCTGT -> TCGTCCCTGTT
ATCGTCGATAG -> TCGTCGATAGA
ATCTACTACTA -> TCTACTACTAA
ATCTAGTTTAG -> TCTAGTTTAGC
ATGAATATCAT -> TGAATATCATA
ATGAATGCGAA -> TGAATGCGAAT
ATGAGCAGGTC -> TGAGCAGGTCC
ATGAGGTACCG -> TGAGGTACCGC
ATGATAAAGGC -> TGATAAAGGCA
ATGATGAATGC -> TGATGAATGCG
ATGCACAAGGG -> TGCACAAGGGA
ATGCCAGGGGG -> TGCCAGGGGGA
ATGCCCTTTTG -> TGCCCTTTTGC
ATGCCTTCTCA -> TGCCTTCTCAC
ATGCGAATTAC -> TGCGAATTACA
ATGCGCCGTGG -> TGCGCCGTGGA
ATGCGGCCGTA -> TGCGGCCGTAG
ATGCGTGCGAG -> TGCGTGCGAGT
ATGCTACACTA -> TGCTACACTAC
ATGCTTATCCG -> TGCTTATCCGT
ATGCTTCCCAC -> TGCTTCCCACC
ATGGAGTATCC -> TGGAGTATCCG
ATGGCCGTTAA -> TGGCCGTTAAC
ATGGTGCCCTC -> TGGTGCCCTCT
ATGTAAAGTAT -> TGTAAAGTATC
ATGTAAATTAT -> TGTAAATTATC
ATGTACGCACA -> TGTACGCACAC
ATGTCCTTCCT -> TGTCCTTCCTA
ATGTCGGTCGC -> TGTCGGTCGCG
ATGTTGTAGCT -> TGTTGTAGCTG
ATGTTGTTCCC -> TGTTGTTCCCC
ATTAAAAGCAC -> TTAAAAGCACA
ATTAAATACCT -> TTAAATACCTT
ATTACAGATGA -> TTACAGATGAA
ATTAGCGTGAA -> TTAGCGTGAAA
ATTAGCTTCTG -> TTAGCTTCTGG
ATTATACCAGG -> TTATACCAGGA
ATTATCTAGTT -> TTATCTAGTTT
ATTATGATAAA -> TTATGATAAAG
ATTCCAAACAC -> TTCCAAACACG
ATTCCAACTGT -> TTCCAACTGTA
ATTCGCTTCAT -> TTCGCTTCATG
ATTCGGCAGTG -> TTCGGCAGTGG
ATTCTTCGACT -> TTCTTCGACTG
ATTCTTCTAGG -> TTCTTCTAGGA
ATTCTTGCATC -> TTCTTGCATCG
ATTGCCTGTAG -> TTGCCTGTAGA
ATTGGGTACGC -> TTGGGTACGCC
ATTGTAGAGTC -> TTGTAGAGTCG
ATTGTCCTCCT -> TTGTCCTCCTA
ATTTAAATGTC -> TTTAAATGTCG
ATTTACAGGAG -> TTTACAGGAGT
ATTTCAGTCAC -> TTTCAGTCACT
ATTTCCATGTA -> TTTCCATGTAA
ATTTCGTGACT -> TTTCGTGACTT
ATTTGAGCGAA -> TTTGAGCGAAC
ATTTGGCACTA -> TTTGGCACTAA
CAAAAACAGCG -> AAAAACAGCGA
CAAAACCCCCC -> AAAACCCCCCT
CAAAACGTCGA -> AAAACGTCGAG
CAAAACGTGCT -> AAAACGTGCTG
CAAAATCGCGT -> AAAATCGCGTA
CAAACACGTGA -> AAACACGTGAG
CAAACGGCGAT -> AAACGGCGATG
CAAATGGCCGT -> AAATGGCCGTT
CAACAGTTAAT -> AACAGTTAATA
CAACCCAGACG -> AACCCAGACGG
CAACCGCCGGT -> AACCGCCGGTG
CAACCTTTTCT -> AACCTTTTCTA
CAACGCTGTAA -> AACGCTGTAAC
CAACGTAACTG -> AACGTAACTGC
CAACTCGGGGG -> AACTCGGGGGG
CAACTGAGTAC -> AACTGAGTACA
CAACTGTAGCA -> AACTGTAGCAC
CAAGACATGAT -> AAGACATGATG
CAAGACCCGGA -> AAGACCCGGAT
CAAGACCGCGT -> AAGACCGCGTG
CAAGAGTTGCA -> AAGAGTTGCAC
CAAGCACCGCG -> AAGCACCGCGA
CAAGCCTGAAG -> AAGCCTGAAGA
CAAGGGAGACC -> AAGGGAGACCC
CAAGTAACAAC -> AAGTAACAACT
CAAGTTCCTTA -> AAGTTCCTTAA
CAAGTTGAAAC -> AAGTTGAAACA
CAATATTCGGC -> AATATTCGGCA
CAATCAGTCCT -> AATCAGTCCTA
CAATGAGCAGG -> AATGAGCAGGT
CAATTATGATA -> AATTATGATAA
CAATTCCAACT -> AATTCCAACTG
CACAAGCCTGA -> ACAAGCCTGAA
CACAAGGGAGA -> ACAAGGGAGAC
CACAATGAGCA -> ACAATGAGCAG
CACACAATGAG -> ACACAATGAGC
CACACGCAGCA -> ACACGCAGCAG
CACAGTGTCTT -> ACAGTGTCTTA
CACATCGGATT -> ACATCGGATTG
CACATTTACAG -> ACATTTACAGG
CACCACTACAC -> ACCACTACACA
CACCGCGACTT -> ACCGCGACTTT
CACCGTAGCTA -> ACCGTAGCTAT
CACCGTTGGGC -> ACCGTTGGGCG
CACCTCACTTT -> ACCTCACTTTT
CACCTCCACGC -> ACCTCCACGCC
CACGACATCGC -> ACGACATCGCA
CACGACTCATG -> ACGACTCATGT
CACGACTCCGC -> ACGACTCCGCG
CACGCAGCAGG -> ACGCAGCAGGG
CACGCCAGAGG -> ACGCCAGAGGA
CACGCCCCGCT -> ACGCCCCGCTT
CACGTGAGACT -> ACGTGAGACTC
CACGTTAGGTA -> ACGTTAGGTAG
CACGTTGAGGG -> ACGTTGAGGGT
CACTAATACAT -> ACTAATACATG
CACTACACATC -> ACTACACATCG
CACTACATTTG -> ACTACATTTGA
CACTAGCAGCC -> ACTAGCAGCCG
CACTAGCCGGG -> ACTAGCCGGGG
CACTGAGTTGA -> ACTGAGTTGAG
CACTGCACGAC -> ACTGCACGACT
CACTTAACATA -> ACTTAACATAT
CACTTCTCAGG -> ACTTCTCAGGG
CACTTTCGTCC -> ACTTTCGTCCC
CACTTTTCGGT -> ACTTTTCGGTT
CACTTTTCTTA -> ACTTTTCTTAC
CAGACCAAAAA -> AGACCAAAAAC
CAGACGGTGGT -> AGACGGTGGTG
CAGAGGAGTAG -> AGAGGAGTAGC
CAGATAAAATA -> AGATAAAATAA
CAGATCCACGC -> AGATCCACGCC
CAGATGAATAT -> AGATGAATATC
CAGCAGGGAAC -> AGCAGGGAACA
CAGCCGATTCC -> AGCCGATTCCA
CAGCCTCACCT -> AGCCTCACCTC
CAGCGACTGTT -> AGCGACTGTTC
CAGCTACCTCT -> AGCTACCTCTC
CAGGAGTTCAA -> AGGAGTTCAAG
CAGGATATATG -> AGGATATATGC
CAGGCCGCTAT -> AGGCCGCTATG
CAGGCTACTGG -> AGGCTACTGGC
CAGGGAACAAT -> AGGGAACAATA
CAGGGGGAGGT -> AGGGGGAGGTC
CAGGGGTTTTG -> AGGGGTTTTGC
CAGGTCCACTT -> AGGTCCACTTC
CAGGTCGACTT -> AGGTCGACTTG
CAGTCACTAGC -> AGTCACTAGCA
CAGTCCTACTT -> AGTCCTACTTA
CAGTCGCGGTG -> AGTCGCGGTGG
CAGTGCTAAGC -> AGTGCTAAGCC
CAGTGGCTCAA -> AGTGGCTCAAC
CAGTGTCTATT -> AGTGTCTATTG
CAGTGTCTTAT -> AGTGTCTTATA
CAGTTAATATT -> AGTTAATATTA
CAGTTCTTGTC -> AGTTCTTGTCT
CAGTTTCTGGT -> AGTTTCTGGTA
CATAGGTACAA -> ATAGGTACAAC
CATAGTCACGA -> ATAGTCACGAC
CATAGTGGCAG -> ATAGTGGCAGG
CATATCCAACG -> ATATCCAACGT
CATATCGTCGA -> ATATCGTCGAT
CATCCAAGTTC -> ATCCAAGTTCC
CATCGAATAAA -> ATCGAATAAAC
CATCGCACTGA -> ATCGCACTGAG
CATCGGATTGC -> ATCGGATTGCC
CATCGGTTTCT -> ATCGGTTTCTA
CATCGTCCCTG -> ATCGTCCCTGT
CATGAGGTACC -> ATGAGGTACCG
CATGATGAATG -> ATGATGAATGC
CATGCCAGGGG -> ATGCCAGGGGG
CATGCCCTTTT -> ATGCCCTTTTG
CATGCTTCCCA -> ATGCTTCCCAC
CATGTAAAGTA -> ATGTAAAGTAT
CATGTAAATTA -> ATGTAAATTAT
CATGTCCTTCC -> ATGTCCTTCCT
CATTAAATACC -> ATTAAATACCT
CATTCGCTTCA -> ATTCGCTTCAT
CATTGTCCTCC -> ATTGTCCTCCT
CATTTACAGGA -> ATTTACAGGAG
CATTTGAGCGA -> ATTTGAGCGAA
CATTTGGCACT -> ATTTGGCACTA
CCAAAAACAGC -> CAAAAACAGCG
CCAAAACCCCC -> CAAAACCCCCC
CCAAACACGTG -> CAAACACGTGA
CCAAATGGCCG -> CAAATGGCCGT
CCAACGTAACT -> CAACGTAACTG
CCAACTGTAGC -> CAACTGTAGCA
CCAAGCACCGC -> CAAGCACCGCG
CCAAGTTCCTT -> CAAGTTCCTTA
CCAATTCCAAC -> CAATTCCAACT
CCACATTTACA -> CACATTTACAG
CCACCACTACA -> CACCACTACAC
CCACCGTAGCT -> CACCGTAGCTA
CCACCTCACTT -> CACCTCACTTT
CCACGCCAGAG -> CACGCCAGAGG
CCACGCCCCGC -> CACGCCCCGCT
CCACTACACAT -> CACTACACATC
CCACTTAACAT -> CACTTAACATA
CCACTTCTCAG -> CACTTCTCAGG
CCACTTTCGTC -> CACTTTCGTCC
CCAGACGGTGG -> CAGACGGTGGT
CCAGAGGAGTA -> CAGAGGAGTAG
CCAGATAAAAT -> CAGATAAAATA
CCAGGATATAT -> CAGGATATATG
CCAGGGGGAGG -> CAGGGGGAGGT
CCAGTGTCTAT -> CAGTGTCTATT
CCATGTAAAGT -> CATGTAAAGTA
CCATTCGCTTC -> CATTCGCTTCA
CCCACATTTAC -> CCACATTTACA
CCCACCACTAC -> CCACCACTACA
CCCACCGTAGC -> CCACCGTAGCT
CCCACCTCACT -> CCACCTCACTT
CCCAGACGGTG -> CCAGACGGTGG
CCCCACATTTA -> CCCACATTTAC
CCCCACCGTAG -> CCCACCGTAGC
CCCCACCTCAC -> CCCACCTCACT
CCCCCACATTT -> CCCCACATTTA
CCCCCCTCCAA -> CCCCCTCCAAA
CCCCCCTTACG -> CCCCCTTACGC
CCCCCTCCAAA -> CCCCTCCAAAA
CCCCCTTACGC -> CCCCTTACGCG
CCCCGAAGTGG -> CCCGAAGTGGC
CCCCGCTTGGG -> CCCGCTTGGGA
CCCCTCCAAAA -> CCCTCCAAAAC
CCCCTTACGCG -> CCCTTACGCGA
CCCGAAGTGGC -> CCGAAGTGGCA
CCCGACGTCGT -> CCGACGTCGTA
CCCGCGATTGG -> CCGCGATTGGG
CCCGCGGCGGT -> CCGCGGCGGTG
CCCGCTTGGGA -> CCGCTTGGGAT
CCCGGATACCC -> CCGGATACCCC
CCCTAGGTGGG -> CCTAGGTGGGC
CCCTAGTTGGT -> CCTAGTTGGTT
CCCTCCAAAAC -> CCTCCAAAACC
CCCTCTCGTAC -> CCTCTCGTACA
CCCTGTTGCTC -> CCTGTTGCTCA
CCCTTACGCGA -> CCTTACGCGAC
CCCTTGCTACA -> CCTTGCTACAT
CCCTTTTGCTG -> CCTTTTGCTGA
CCGAAGTGGCA -> CGAAGTGGCAA
CCGACAGGTCG -> CGACAGGTCGA
CCGACGTCGTA -> CGACGTCGTAA
CCGATTCCAAA -> CGATTCCAAAC
CCGCCGGTGAG -> CGCCGGTGAGT
CCGCGACTTTC -> CGCGACTTTCA
CCGCGATTGGG -> CGCGATTGGGT
CCGCGCGCGAT -> CGCGCGCGATA
CCGCGGCGGTG -> CGCGGCGGTGA
CCGCGTGTTGT -> CGCGTGTTGTC
CCGCGTTCATA -> CGCGTTCATAG
CCGCTATGCGG -> CGCTATGCGGC
CCGCTGTTATT -> CGCTGTTATTC
CCGCTTGGGAT -> CGCTTGGGATT
CCGGATACCCC -> CGGATACCCCA
CCGGGGGCCGG -> CGGGGGCCGGT
CCGGGGTACTA -> CGGGGTACTAT
CCGGTCAAAAC -> CGGTCAAAACG
CCGGTGAGTCG -> CGGTGAGTCGG
CCGGTGTGCCC -> CGGTGTGCCCG
CCGGTGTGGAG -> CGGTGTGGAGT
CCGTAGACGCC -> CGTAGACGCCC
CCGTAGCTATT -> CGTAGCTATTT
CCGTCGGGTCT -> CGTCGGGTCTA
CCGTGGAGTAT -> CGTGGAGTATC
CCGTGTCTTCT -> CGTGTCTTCTA
CCGTTAACGAA -> CGTTAACGAAG
CCGTTGGGCGC -> CGTTGGGCGCA
CCGTTGTATGC -> CGTTGTATGCC
CCTAATTAGCT -> CTAATTAGCTT
CCTACCCGCGG -> CTACCCGCGGC
CCTACTTAAGC -> CTACTTAAGCC
CCTAGGAAGTA -> CTAGGAAGTAG
CCTAGGTGGGC -> CTAGGTGGGCA
CCTAGTTGGTT -> CTAGTTGGTTA
CCTATGGTGCC -> CTATGGTGCCC
CCTCACCTCCA -> CTCACCTCCAC
CCTCACGTTAG -> CTCACGTTAGG
CCTCACTTTTC -> CTCACTTTTCT
CCTCCAAAACC -> CTCCAAAACCC
CCTCCACGCCA -> CTCCACGCCAG
CCTCCTAATTA -> CTCCTAATTAG
CCTCGGTGTCT -> CTCGGTGTCTC
CCTCTCCTTAG -> CTCTCCTTAGG
CCTCTCGTACA -> CTCTCGTACAG
CCTGAAGAGAG -> CTGAAGAGAGG
CCTGGCAGTGC -> CTGGCAGTGCT
CCTGTAGAGGC -> CTGTAGAGGCC
CCTGTTGCTCA -> CTGTTGCTCAG
CCTTAATTTCA -> CTTAATTTCAG
CCTTACGCGAC -> CTTACGCGACA
CCTTAGGAGTG -> CTTAGGAGTGT
CCTTCCTATGG -> CTTCCTATGGT
CCTTCGGTCAA -> CTTCGGTCAAC
CCTTCTCACCG -> CTTCTCACCGT
CCTTGCTACAT -> CTTGCTACATG
CCTTTTCTACC -> CTTTTCTACCG
CCTTTTGCTGA -> CTTTTGCTGAC
CGAACGCTGTT -> GAACGCTGTTC
CGAAGGGGCGG -> GAAGGGGCGGG
CGAAGGGTCGT -> GAAGGGTCGTT
CGAAGTGGCAA -> GAAGTGGCAAG
CGAATAAACTG -> GAATAAACTGT
CGAATCACGAC -> GAATCACGACA
CGAATTACAGA -> GAATTACAGAT
CGACAAAATCG -> GACAAAATCGC
CGACAAGAGTT -> GACAAGAGTTG
CGACAGGTCGA -> GACAGGTCGAC
CGACATATCGT -> GACATATCGTC
CGACATCGCAC -> GACATCGCACT
CGACGACGCTG -> GACGACGCTGG
CGACGCTGGGT -> GACGCTGGGTG
CGACGTCGTAA -> GACGTCGTAAC
CGACTCATGTC -> GACTCATGTCC
CGACTCCGCGC -> GACTCCGCGCG
CGACTCGAGTC -> GACTCGAGTCT
CGACTGTAGAT -> GACTGTAGATG
CGACTGTTCAG -> GACTGTTCAGT
CGACTTGCTCT -> GACTTGCTCTC
CGACTTTCACA -> GACTTTCACAA
CGAGATTATAC -> GAGATTATACC
CGAGCTCTGAT -> GAGCTCTGATA
CGAGTCTTGCT -> GAGTCTTGCTC
CGAGTGGTTTT -> GAGTGGTTTTG
CGATACGTTAT -> GATACGTTATA
CGATAGAACAT -> GATAGAACATC
CGATAGCTTTT -> GATAGCTTTTC
CGATGTTGTTC -> GATGTTGTTCC
CGATTCCAAAC -> GATTCCAAACA
CGATTGGGTAC -> GATTGGGTACG
CGCAACGCTGT -> GCAACGCTGTA
CGCACACAATG -> GCACACAATGA
CGCACTGAGTT -> GCACTGAGTTG
CGCAGCAGGGA -> GCAGCAGGGAA
CGCCACTTTCG -> GCCACTTTCGT
CGCCAGAGGAG -> GCCAGAGGAGT
CGCCCCGAAGT -> GCCCCGAAGTG
CGCCCCGCTTG -> GCCCCGCTTGG
CGCCGGTGAGT -> GCCGGTGAGTC
CGCCGTGGAGT -> GCCGTGGAGTA
CGCGACATATC -> GCGACATATCG
CGCGACTTTCA -> GCGACTTTCAC
CGCGATAGCTT -> GCGATAGCTTT
CGCGATTGGGT -> GCGATTGGGTA
CGCGCGATAGC -> GCGCGATAGCT
CGCGCGCGATA -> GCGCGCGATAG
CGCGGCGGTGA -> GCGGCGGTGAG
CGCGGTACATT -> GCGGTACATTA
CGCGGTGGTGT -> GCGGTGGTGTA
CGCGTAGTAGC -> GCGTAGTAGCA
CGCGTCTACAG -> GCGTCTACAGC
CGCGTGTTGTC -> GCGTGTTGTCC
CGCGTTCATAG -> GCGTTCATAGT
CGCTATGCGGC -> GCTATGCGGCC
CGCTGGGTGAT -> GCTGGGTGATT
CGCTGTAACCG -> GCTGTAACCGG
CGCTGTTATTC -> GCTGTTATTCT
CGCTGTTCTGG -> GCTGTTCTGGG
CGCTTCATGCT -> GCTTCATGCTT
CGCTTGGGATT -> GCTTGGGATTA
CGGAGTCGACA -> GGAGTCGACAA
CGGATACCCCA -> GGATACCCCAC
CGGATTGCCTG -> GGATTGCCTGT
CGGCAGTGGCT -> GGCAGTGGCTC
CGGCCGTAGAC -> GGCCGTAGACG
CGGCCTGGCAG -> GGCCTGGCAGT
CGGCGATGTTG -> GGCGATGTTGT
CGGCGGTGAGT -> GGCGGTGAGTA
CGGGCGTTCAA -> GGGCGTTCAAT
CGGGGGCCGGT -> GGGGGCCGGTG
CGGGGGGGAAC -> GGGGGGGAACA
CGGGGTACTAT -> GGGGTACTATG
CGGGTCCAGAT -> GGGTCCAGATA
CGGGTCTACGT -> GGGTCTACGTG
CGGGTTACGGA -> GGGTTACGGAG
CGGGTTTTTCG -> GGGTTTTTCGT
CGGTACATTAA -> GGTACATTAAA
CGGTCAAAACG -> GGTCAAAACGT
CGGTCAACCCA -> GGTCAACCCAG
CGGTCGCGTCT -> GGTCGCGTCTA
CGGTGAGTATG -> GGTGAGTATGC
CGGTGAGTCGG -> GGTGAGTCGGG
CGGTGGTGTAC -> GGTGGTGTACC,GGTGGTGTACG
CGGTGTCTCTC -> GGTGTCTCTCA
CGGTGTGCCCG -> GGTGTGCCCGC
CGGTGTGGAGT -> GGTGTGGAGTA
CGGTTTCTAGT -> GGTTTCTAGTT
CGGTTTTGTTG -> GGTTTTGTTGT
CGTAACGACTC -> GTAACGACTCG
CGTAACTGAGG -> GTAACTGAGGG
CGTAACTGCTA -> GTAACTGCTAT
CGTACAGGCCG -> GTACAGGCCGC
CGTAGACGCCC -> GTAGACGCCCC
CGTAGCTATTT -> GTAGCTATTTC
CGTAGTAGCAG -> GTAGTAGCAGC
CGTCCCTGTTG -> GTCCCTGTTGC
CGTCCCTTGCT -> GTCCCTTGCTA
CGTCGAGCTCT -> GTCGAGCTCTG
CGTCGATAGAA -> GTCGATAGAAC
CGTCGGGTCTA -> GTCGGGTCTAC
CGTCGTAACTG -> GTCGTAACTGA
CGTCTACAGCT -> GTCTACAGCTA
CGTGAAAACGA -> GTGAAAACGAG
CGTGACTTCTA -> GTGACTTCTAG
CGTGAGACTCC -> GTGAGACTCCC
CGTGCGAGTGG -> GTGCGAGTGGT
CGTGCTGCAAC -> GTGCTGCAACC
CGTGGAGTATC -> GTGGAGTATCC
CGTGTCTCTTC -> GTGTCTCTTCC
CGTGTCTTCTA -> GTGTCTTCTAA
CGTGTTGTCCT -> GTGTTGTCCTA
CGTTAACGAAG -> GTTAACGAAGG
CGTTAGGTAGG -> GTTAGGTAGGT
CGTTATAGCTT -> GTTATAGCTTC
CGTTCAATCAG -> GTTCAATCAGT
CGTTCATAGTC -> GTTCATAGTCA
CGTTGAGGGTA -> GTTGAGGGTAA
CGTTGGGCGCA -> GTTGGGCGCAA
CGTTGGGTAGC -> GTTGGGTAGCT
CGTTGGTATAT -> GTTGGTATATG
CGTTGTATGCC -> GTTGTATGCCT
CTAACTCCTCA -> TAACTCCTCAC
CTAAGAACTTG -> TAAGAACTTGC
CTAAGCCCTAG -> TAAGCCCTAGT
CTAATACATGT -> TAATACATGTA
CTAATTAGCTT -> TAATTAGCTTC
CTACACATCGG -> TACACATCGGA
CTACACTACAT -> TACACTACATT
CTACAGCTACC -> TACAGCTACCT
CTACATGCCAG -> TACATGCCAGG
CTACATTTGAG -> TACATTTGAGC
CTACCCGCGGC -> TACCCGCGGCG
CTACCGTCGGG -> TACCGTCGGGT
CTACCTCTCCT -> TACCTCTCCTT
CTACGTGTCTC -> TACGTGTCTCT
CTACTAACTCC -> TACTAACTCCT
CTACTACTAAC -> TACTACTAACT
CTACTGGCATC -> TACTGGCATCG
CTACTTAAGCC -> TACTTAAGCCA
CTAGCAGCCGA -> TAGCAGCCGAT
CTAGCCGGGGG -> TAGCCGGGGGC
CTAGCGAAGGG -> TAGCGAAGGGG
CTAGGAAGTAG -> TAGGAAGTAGT
CTAGGATTCTT -> TAGGATTCTTC
CTAGGTGGGCA -> TAGGTGGGCAT
CTAGTTGGGAA -> TAGTTGGGAAC
CTAGTTGGTTA -> TAGTTGGTTAC
CTAGTTTAGCC -> TAGTTTAGCCG
CTATAAGTGCC -> TATAAGTGCCA
CTATCCGTTGT -> TATCCGTTGTA
CTATGCGGCCG -> TATGCGGCCGT
CTATGGTGCCC -> TATGGTGCCCT
CTATGTTGTAG -> TATGTTGTAGC
CTATTGTAGAG -> TATTGTAGAGT
CTATTTCCATG -> TATTTCCATGT
CTCAACCGCCG -> TCAACCGCCGG
CTCACCGTTGG -> TCACCGTTGGG
CTCACCTCCAC -> TCACCTCCACG
CTCACGTTAGG -> TCACGTTAGGT
CTCACTTTTCT -> TCACTTTTCTT
CTCAGATCCAC -> TCAGATCCACG
CTCAGGGGTTT -> TCAGGGGTTTT
CTCAGTTTCTG -> TCAGTTTCTGG
CTCATGTCCTT -> TCATGTCCTTC
CTCCAAAACCC -> TCCAAAACCCC
CTCCACGCCAG -> TCCACGCCAGA
CTCCCCCACAT -> TCCCCCACATT
CTCCGCGCGCG -> TCCGCGCGCGA
CTCCTAATTAG -> TCCTAATTAGC
CTCCTCACGTT -> TCCTCACGTTA
CTCCTTAGGAG -> TCCTTAGGAGT
CTCGACGACGC -> TCGACGACGCT
CTCGAGTCTTG -> TCGAGTCTTGC
CTCGGGGGGGA -> TCGGGGGGGAA
CTCGGTGTCTC -> TCGGTGTCTCT
CTCGTACAGGC -> TCGTACAGGCC
CTCTCAGATCC -> TCTCAGATCCA
CTCTCCTTAGG -> TCTCCTTAGGA
CTCTCGTACAG -> TCTCGTACAGG
CTCTCTAGTCT -> TCTCTAGTCTG
CTCTGATAACA -> TCTGATAACAA
CTCTTCCACTT -> TCTTCCACTTA
CTGAAGAGAGG -> TGAAGAGAGGA
CTGACATAGGT -> TGACATAGGTA
CTGAGGGGTGG -> TGAGGGGTGGT
CTGAGTACAAA -> TGAGTACAAAA
CTGAGTTGAGC -> TGAGTTGAGCA
CTGATAACAAC -> TGATAACAACA
CTGCAACCTTT -> TGCAACCTTTT
CTGCACGACTC -> TGCACGACTCA
CTGCTATCCGT -> TGCTATCCGTT
CTGGCAGTGCT -> TGGCAGTGCTA
CTGGCATCGAA -> TGGCATCGAAT
CTGGGATCAGT -> TGGGATCAGTC
CTGGGTGATTT -> TGGGTGATTTA
CTGGTAGGGTT -> TGGTAGGGTTT
CTGGTGACCGG -> TGGTGACCGGG
CTGTAACCGGT -> TGTAACCGGTG
CTGTAGAGGCC -> TGTAGAGGCCA
CTGTAGATGCA -> TGTAGATGCAC
CTGTAGCACGT -> TGTAGCACGTT
CTGTCAAACGG -> TGTCAAACGGC
CTGTTAATGGA -> TGTTAATGGAG
CTGTTATGCTT -> TGTTATGCTTA
CTGTTATTCTT -> TGTTATTCTTC
CTGTTCAGTTC -> TGTTCAGTTCT
CTGTTCTGGGA -> TGTTCTGGGAT
CTGTTGCTCAG -> TGTTGCTCAGT
CTTAACATATC -> TTAACATATCC
CTTAAGCCATT -> TTAAGCCATTC
CTTAATTTCAG -> TTAATTTCAGT
CTTACGCGACA -> TTACGCGACAT
CTTACTTGTTG -> TTACTTGTTGT
CTTAGGAGTGT -> TTAGGAGTGTG
CTTATATGTAC -> TTATATGTACG
CTTATCCGTGT -> TTATCCGTGTC
CTTCATGCTTC -> TTCATGCTTCC
CTTCATTGTCC -> TTCATTGTCCT
CTTCCACTTAA -> TTCCACTTAAC
CTTCCCACCAC -> TTCCCACCACT
CTTCCGGTCAA -> TTCCGGTCAAA
CTTCCTATGGT -> TTCCTATGGTG
CTTCGACTGTA -> TTCGACTGTAG
CTTCGGTCAAC -> TTCGGTCAACC
CTTCTAAGAAC -> TTCTAAGAACT
CTTCTAGCGAA -> TTCTAGCGAAG
CTTCTAGGATT -> TTCTAGGATTC
CTTCTCACCGT -> TTCTCACCGTT
CTTCTCAGGGG -> TTCTCAGGGGT
CTTCTGGTGAC -> TTCTGGTGACC
CTTGCAAGACC -> TTGCAAGACCC
CTTGCATCGTC -> TTGCATCGTCC
CTTGCTACATG -> TTGCTACATGC
CTTGCTCGACG -> TTGCTCGACGA
CTTGCTCTCTA -> TTGCTCTCTAG
CTTGGGATTAA -> TTGGGATTAAA
CTTGTCTTGTT -> TTGTCTTGTTG
CTTGTTGGCCC -> TTGTTGGCCCC
CTTGTTGTCCT -> TTGTTGTCCTA
CTTTCACAAGC -> TTTCACAAGCC
CTTTCGTCCCT -> TTTCGTCCCTT
CTTTTCATGAG -> TTTTCATGAGG
CTTTTCGGTTT -> TTTTCGGTTTT
CTTTTCTACCG -> TTTTCTACCGT
CTTTTCTTACT -> TTTTCTTACTT
CTTTTGCTGAC -> TTTTGCTGACA
GAAAACGAGAT -> AAAACGAGATT
GAAACAAGACA -> AAACAAGACAT
GAACAATATTC -> AACAATATTCG
GAACAATTATG -> AACAATTATGA
GAACACTGCAC -> AACACTGCACG
GAACATCCAAG -> AACATCCAAGT
GAACGCTGTTC -> AACGCTGTTCT
GAACGGGCGTT -> AACGGGCGTTC
GAACTTGCAAG -> AACTTGCAAGA
GAAGACAGACC -> AAGACAGACCA
GAAGAGAGGAC -> AAGAGAGGACG
GAAGGGGCGGG -> AAGGGGCGGGT
GAAGGGTCGTT -> AAGGGTCGTTG
GAAGTAGTGAA -> AAGTAGTGAAC
GAAGTGGCAAG -> AAGTGGCAAGA
GAATAAACTGT -> AATAAACTGTT
GAATATCATAG -> AATATCATAGT
GAATCACGACA -> AATCACGACAT
GAATGCGAATT -> AATGCGAATTA
GAATTACAGAT -> AATTACAGATG
GACAAAATCGC -> ACAAAATCGCG
GACAAGAGTTG -> ACAAGAGTTGC
GACAGACCAAA -> ACAGACCAAAA
GACAGGTCGAC -> ACAGGTCGACT
GACATAGGTAC -> ACATAGGTACA
GACATATCGTC -> ACATATCGTCG
GACATCGCACT -> ACATCGCACTG
GACATGATGAA -> ACATGATGAAT
GACCAAAAACA -> ACCAAAAACAG
GACCAAATGGC -> ACCAAATGGCC
GACCCGACGTC -> ACCCGACGTCG
GACCCGGATAC -> ACCCGGATACC
GACCGCGTGTT -> ACCGCGTGTTG
GACCGGGGTAC -> ACCGGGGTACT
GACGACGCTGG -> ACGACGCTGGG
GACGCCCCGAA -> ACGCCCCGAAG
GACGCTGGGTG -> ACGCTGGGTGA
GACGGTGGTGT -> ACGGTGGTGTA
GACGTAACGAC -> ACGTAACGACT
GACGTCGTAAC -> ACGTCGTAACT
GACTCATGTCC -> ACTCATGTCCT
GACTCCCCCAC -> ACTCCCCCACA
GACTCCGCGCG -> ACTCCGCGCGC
GACTCGAGTCT -> ACTCGAGTCTT
GACTGTAGATG -> ACTGTAGATGC
GACTGTTCAGT -> ACTGTTCAGTT
GACTTCTAGCG -> ACTTCTAGCGA
GACTTGCTCTC -> ACTTGCTCTCT
GACTTTCACAA -> ACTTTCACAAG
GAGACCCGACG -> AGACCCGACGT
GAGACTCCCCC -> AGACTCCCCCA
GAGAGGACGTA -> AGAGGACGTAA
GAGATTATACC -> AGATTATACCA
GAGCAGGTCCA -> AGCAGGTCCAC
GAGCATCGGTT -> AGCATCGGTTT
GAGCGAACGCT -> AGCGAACGCTG
GAGCTCTGATA -> AGCTCTGATAA
GAGGACGTAAC -> AGGACGTAACG
GAGGAGTAGCG -> AGGAGTAGCGG
GAGGCCAATTC -> AGGCCAATTCC
GAGGGGTGGTC -> AGGGGTGGTCG
GAGGGTAAATC -> AGGGTAAATCA
GAGGGTAGACC -> AGGGTAGACCA
GAGGTACCGCT -> AGGTACCGCTG
GAGGTCGAATC -> AGGTCGAATCA
GAGTACAAAAC -> AGTACAAAACG
GAGTAGCGGGT -> AGTAGCGGGTC
GAGTAGTAAGA -> AGTAGTAAGAT
GAGTATCCCTA -> AGTATCCCTAG
GAGTATCCGCG -> AGTATCCGCGT
GAGTATGCGTG -> AGTATGCGTGC
GAGTCGACAAA -> AGTCGACAAAA
GAGTCGGCCTG -> AGTCGGCCTGG
GAGTCGGGTTT -> AGTCGGGTTTT
GAGTCTTGCTC -> AGTCTTGCTCG
GAGTGGTTTTG -> AGTGGTTTTGG
GAGTGTGAAGA -> AGTGTGAAGAC
GAGTTCAAGTA -> AGTTCAAGTAA
GAGTTGAGCAT -> AGTTGAGCATC
GAGTTGCACTT -> AGTTGCACTTT
GATAAAATAAA -> ATAAAATAAAG
GATAAAGGCAC -> ATAAAGGCACT
GATAACAACAG -> ATAACAACAGT
GATACCCCACC -> ATACCCCACCG
GATACGTTATA -> ATACGTTATAG
GATAGAACATC -> ATAGAACATCC
GATAGCTTTTC -> ATAGCTTTTCA
GATATATGCGC -> ATATATGCGCC
GATCAGTCGCG -> ATCAGTCGCGG
GATCCACGCCC -> ATCCACGCCCC
GATGAATATCA -> ATGAATATCAT
GATGAATGCGA -> ATGAATGCGAA
GATGCACAAGG -> ATGCACAAGGG
GATGTTGTTCC -> ATGTTGTTCCC
GATTAAAAGCA -> ATTAAAAGCAC
GATTATACCAG -> ATTATACCAGG
GATTCCAAACA -> ATTCCAAACAC
GATTCTTCGAC -> ATTCTTCGACT
GATTGCCTGTA -> ATTGCCTGTAG
GATTGGGTACG -> ATTGGGTACGC
GATTTAAATGT -> ATTTAAATGTC
GATTTCGTGAC -> ATTTCGTGACT
GCAACCTTTTC -> CAACCTTTTCT
GCAACGCTGTA -> CAACGCTGTAA
GCAAGACCCGG -> CAAGACCCGGA
GCAAGACCGCG -> CAAGACCGCGT
GCACAAGGGAG -> CACAAGGGAGA
GCACACAATGA -> CACACAATGAG
GCACACGCAGC -> CACACGCAGCA
GCACAGTGTCT -> CACAGTGTCTT
GCACCGCGACT -> CACCGCGACTT
GCACGACTCAT -> CACGACTCATG
GCACGTTGAGG -> CACGTTGAGGG
GCACTAATACA -> CACTAATACAT
GCACTAGCCGG -> CACTAGCCGGG
GCACTGAGTTG -> CACTGAGTTGA
GCACTTTTCGG -> CACTTTTCGGT
GCAGCAGGGAA -> CAGCAGGGAAC
GCAGCCGATTC -> CAGCCGATTCC
GCAGCCTCACC -> CAGCCTCACCT
GCAGGCTACTG -> CAGGCTACTGG
GCAGGGAACAA -> CAGGGAACAAT
GCAGGTCCACT -> CAGGTCCACTT
GCAGTGCTAAG -> CAGTGCTAAGC
GCAGTGGCTCA -> CAGTGGCTCAA
GCATCGAATAA -> CATCGAATAAA
GCATCGGTTTC -> CATCGGTTTCT
GCATCGTCCCT -> CATCGTCCCTG
GCATGCCCTTT -> CATGCCCTTTT
GCCAATTCCAA -> CCAATTCCAAC
GCCACTTTCGT -> CCACTTTCGTC
GCCAGAGGAGT -> CCAGAGGAGTA
GCCAGGGGGAG -> CCAGGGGGAGG
GCCAGTGTCTA -> CCAGTGTCTAT
GCCATTCGCTT -> CCATTCGCTTC
GCCCCCCTCCA -> CCCCCCTCCAA
GCCCCGAAGTG -> CCCCGAAGTGG
GCCCCGCTTGG -> CCCCGCTTGGG
GCCCGCGATTG -> CCCGCGATTGG
GCCCTAGTTGG -> CCCTAGTTGGT
GCCCTCTCGTA -> CCCTCTCGTAC
GCCCTTTTGCT -> CCCTTTTGCTG
GCCGACAGGTC -> CCGACAGGTCG
GCCGATTCCAA -> CCGATTCCAAA
GCCGCTATGCG -> CCGCTATGCGG
GCCGGGGGCCG -> CCGGGGGCCGG
GCCGGTGAGTC -> CCGGTGAGTCG
GCCGGTGTGCC -> CCGGTGTGCCC
GCCGTAGACGC -> CCGTAGACGCC
GCCGTGGAGTA -> CCGTGGAGTAT
GCCGTTAACGA -> CCGTTAACGAA
GCCTCACCTCC -> CCTCACCTCCA
GCCTGAAGAGA -> CCTGAAGAGAG
GCCTGGCAGTG -> CCTGGCAGTGC
GCCTGTAGAGG -> CCTGTAGAGGC
GCCTTCTCACC -> CCTTCTCACCG
GCGAACGCTGT -> CGAACGCTGTT
GCGAAGGGGCG -> CGAAGGGGCGG
GCGAATTACAG -> CGAATTACAGA
GCGACATATCG -> CGACATATCGT
GCGACTGTTCA -> CGACTGTTCAG
GCGACTTTCAC -> CGACTTTCACA
GCGAGTGGTTT -> CGAGTGGTTTT
GCGATAGCTTT -> CGATAGCTTTT
GCGATGTTGTT -> CGATGTTGTTC
GCGATTGGGTA -> CGATTGGGTAC
GCGCAACGCTG -> CGCAACGCTGT
GCGCCGTGGAG -> CGCCGTGGAGT
GCGCGATAGCT -> CGCGATAGCTT
GCGCGCGATAG -> CGCGCGATAGC
GCGGCCGTAGA -> CGGCCGTAGAC
GCGGCGGTGAG -> CGGCGGTGAGT
GCGGGTCCAGA -> CGGGTCCAGAT
GCGGGTTACGG -> CGGGTTACGGA
GCGGTACATTA -> CGGTACATTAA
GCGGTGAGTAT -> CGGTGAGTATG
GCGGTGGTGTA -> CGGTGGTGTAC
GCGTAGTAGCA -> CGTAGTAGCAG
GCGTCTACAGC -> CGTCTACAGCT
GCGTGAAAACG -> CGTGAAAACGA
GCGTGCGAGTG -> CGTGCGAGTGG
GCGTGTTGTCC -> CGTGTTGTCCT
GCGTTCAATCA -> CGTTCAATCAG
GCGTTCATAGT -> CGTTCATAGTC
GCTAAGCCCTA -> CTAAGCCCTAG
GCTACACTACA -> CTACACTACAT
GCTACATGCCA -> CTACATGCCAG
GCTACCTCTCC -> CTACCTCTCCT
GCTACTGGCAT -> CTACTGGCATC
GCTATAAGTGC -> CTATAAGTGCC
GCTATCCGTTG -> CTATCCGTTGT
GCTATGCGGCC -> CTATGCGGCCG
GCTATTTCCAT -> CTATTTCCATG
GCTCAACCGCC -> CTCAACCGCCG
GCTCAGTTTCT -> CTCAGTTTCTG
GCTCGACGACG -> CTCGACGACGC
GCTCTCTAGTC -> CTCTCTAGTCT
GCTCTGATAAC -> CTCTGATAACA
GCTGACATAGG -> CTGACATAGGT
GCTGCAACCTT -> CTGCAACCTTT
GCTGGGTGATT -> CTGGGTGATTT
GCTGTAACCGG -> CTGTAACCGGT
GCTGTCAAACG -> CTGTCAAACGG
GCTGTTAATGG -> CTGTTAATGGA
GCTGTTATTCT -> CTGTTATTCTT
GCTGTTCTGGG -> CTGTTCTGGGA
GCTTATCCGTG -> CTTATCCGTGT
GCTTCATGCTT -> CTTCATGCTTC
GCTTCATTGTC -> CTTCATTGTCC
GCTTCCCACCA -> CTTCCCACCAC
GCTTCCGGTCA -> CTTCCGGTCAA
GCTTCTGGTGA -> CTTCTGGTGAC
GCTTGGGATTA -> CTTGGGATTAA
GCTTTTCATGA -> CTTTTCATGAG
GGAACAATATT -> GAACAATATTC
GGAACAATTAT -> GAACAATTATG
GGAACGGGCGT -> GAACGGGCGTT
GGAAGTAGTGA -> GAAGTAGTGAA
GGACGTAACGA -> GACGTAACGAC
GGAGACCCGAC -> GAGACCCGACG
GGAGGTCGAAT -> GAGGTCGAATC
GGAGTAGCGGG -> GAGTAGCGGGT
GGAGTAGTAAG -> GAGTAGTAAGA
GGAGTATCCCT -> GAGTATCCCTA
GGAGTATCCGC -> GAGTATCCGCG
GGAGTCGACAA -> GAGTCGACAAA
GGAGTGTGAAG -> GAGTGTGAAGA
GGAGTTCAAGT -> GAGTTCAAGTA
GGATACCCCAC -> GATACCCCACC
GGATATATGCG -> GATATATGCGC
GGATCAGTCGC -> GATCAGTCGCG
GGATTAAAAGC -> GATTAAAAGCA
GGATTCTTCGA -> GATTCTTCGAC
GGATTGCCTGT -> GATTGCCTGTA
GGCAAGACCGC -> GCAAGACCGCG
GGCACTAATAC -> GCACTAATACA
GGCACTAGCCG -> GCACTAGCCGG
GGCAGGCTACT -> GCAGGCTACTG
GGCAGTGCTAA -> GCAGTGCTAAG
GGCAGTGGCTC -> GCAGTGGCTCA
GGCATCGAATA -> GCATCGAATAA
GGCATGCCCTT -> GCATGCCCTTT
GGCCAATTCCA -> GCCAATTCCAA
GGCCCCCCTCC -> GCCCCCCTCCA
GGCCGCTATGC -> GCCGCTATGCG
GGCCGGTGTGC -> GCCGGTGTGCC
GGCCGTAGACG -> GCCGTAGACGC
GGCCGTTAACG -> GCCGTTAACGA
GGCCTGGCAGT -> GCCTGGCAGTG
GGCGATGTTGT -> GCGATGTTGTT
GGCGCAACGCT -> GCGCAACGCTG
GGCGGGTTACG -> GCGGGTTACGG
GGCGGTGAGTA -> GCGGTGAGTAT
GGCGTTCAATC -> GCGTTCAATCA
GGCTACTGGCA -> GCTACTGGCAT
GGCTATAAGTG -> GCTATAAGTGC
GGCTCAACCGC -> GCTCAACCGCC
GGGAACAATAT -> GGAACAATATT
GGGAACAATTA -> GGAACAATTAT
GGGAACGGGCG -> GGAACGGGCGT
GGGAGACCCGA -> GGAGACCCGAC
GGGAGGTCGAA -> GGAGGTCGAAT
GGGATCAGTCG -> GGATCAGTCGC
GGGATTAAAAG -> GGATTAAAAGC
GGGCATGCCCT -> GGCATGCCCTT
GGGCCGGTGTG -> GGCCGGTGTGC
GGGCGCAACGC -> GGCGCAACGCT
GGGCGGGTTAC -> GGCGGGTTACG
GGGCGTTCAAT -> GGCGTTCAATC
GGGGAACAATT -> GGGAACAATTA
GGGGAGGTCGA -> GGGAGGTCGAA
GGGGCCGGTGT -> GGGCCGGTGTG
GGGGCGGGTTA -> GGGCGGGTTAC
GGGGGAACAAT -> GGGGAACAATT
GGGGGAGGTCG -> GGGGAGGTCGA
GGGGGCCGGTG -> GGGGCCGGTGT
GGGGGGAACAA -> GGGGGAACAAT
GGGGGGGAACA -> GGGGGGAACAA
GGGGTACTATG -> GGGTACTATGT
GGGGTGGCTAT -> GGGTGGCTATA
GGGGTGGTCGC -> GGGTGGTCGCG
GGGGTTTTGCT -> GGGTTTTGCTT
GGGTAAATCAA -> GGTAAATCAAG
GGGTACGCCAC -> GGTACGCCACT
GGGTACTATGT -> GGTACTATGTT
GGGTAGACCAA -> GGTAGACCAAA
GGGTAGCTGTT -> GGTAGCTGTTA
GGGTCCAGATA -> GGTCCAGATAA
GGGTCGTTGGT -> GGTCGTTGGTA
GGGTCTACGTG -> GGTCTACGTGT
GGGTGATTTAA -> GGTGATTTAAA
GGGTGGCTATA -> GGTGGCTATAA
GGGTGGTCGCG -> GGTGGTCGCGG
GGGTTACGGAG -> GGTTACGGAGT
GGGTTCGATAC -> GGTTCGATACG
GGGTTTTGCTT -> GGTTTTGCTTC
GGGTTTTTCGT -> GGTTTTTCGTT
GGGTTTTTGTT -> GGTTTTTGTTA
GGTAAATCAAG -> GTAAATCAAGT
GGTACAACTGA -> GTACAACTGAG
GGTACATTAAA -> GTACATTAAAT
GGTACCGCTGT -> GTACCGCTGTT
GGTACGCCACT -> GTACGCCACTT
GGTACTATGTT -> GTACTATGTTG
GGTAGACCAAA -> GTAGACCAAAT
GGTAGCTGTTA -> GTAGCTGTTAA
GGTAGGGTTTT -> GTAGGGTTTTT
GGTAGGTCCTC -> GTAGGTCCTCG
GGTATATGCTA -> GTATATGCTAC
GGTCAAAACGT -> GTCAAAACGTC
GGTCAACCCAG -> GTCAACCCAGA
GGTCCACTTCT -> GTCCACTTCTC
GGTCCAGATAA -> GTCCAGATAAA
GGTCCTCGGTG -> GTCCTCGGTGT
GGTCGAATCAC -> GTCGAATCACG
GGTCGACTTGC -> GTCGACTTGCT
GGTCGCGGTAC -> GTCGCGGTACA
GGTCGCGTCTA -> GTCGCGTCTAC
GGTCGTTGGTA -> GTCGTTGGTAT
GGTCTACGTGT -> GTCTACGTGTC
GGTGACCGGGG -> GTGACCGGGGT
GGTGAGTATGC -> GTGAGTATGCG
GGTGAGTCGGG -> GTGAGTCGGGT
GGTGATTTAAA -> GTGATTTAAAT
GGTGCACAGTG -> GTGCACAGTGT
GGTGCCCTCTC -> GTGCCCTCTCG
GGTGGCTATAA -> GTGGCTATAAG
GGTGGGCATGC -> GTGGGCATGCC
GGTGGTCGCGG -> GTGGTCGCGGT
GGTGGTGTACC -> GTGGTGTACCA
GGTGGTGTACG -> GTGGTGTACGA
GGTGTACCAAG -> GTGTACCAAGC
GGTGTACGACA -> GTGTACGACAA
GGTGTCTCTCA -> GTGTCTCTCAG
GGTGTGCCCGC -> GTGTGCCCGCG
GGTGTGGAGTA -> GTGTGGAGTAG
GGTTACATTTG -> GTTACATTTGG
GGTTACGGAGT -> GTTACGGAGTC
GGTTCGATACG -> GTTCGATACGT
GGTTTCTAGTT -> GTTTCTAGTTG
GGTTTTGCTTC -> GTTTTGCTTCC
GGTTTTGGTGC -> GTTTTGGTGCA
GGTTTTGTTGT -> GTTTTGTTGTT
GGTTTTTCGTT -> GTTTTTCGTTG
GGTTTTTGTTA -> GTTTTTGTTAG
GTAAAGTATCT -> TAAAGTATCTA
GTAAATCAAGT -> TAAATCAAGTT
GTAAATTATCT -> TAAATTATCTA
GTAACAACTCG -> TAACAACTCGG
GTAACCGGTGT -> TAACCGGTGTG
GTAACGACTCG -> TAACGACTCGA
GTAACTGAGGG -> TAACTGAGGGG
GTAACTGCTAT -> TAACTGCTATC
GTAAGATTTCG -> TAAGATTTCGT
GTACAAAACGT -> TACAAAACGTG
GTACAACTGAG -> TACAACTGAGT
GTACAGGCCGC -> TACAGGCCGCT
GTACATTAAAT -> TACATTAAATA
GTACCAAGCAC -> TACCAAGCACC
GTACCGCTGTT -> TACCGCTGTTA
GTACGACAAGA -> TACGACAAGAG
GTACGCACACA -> TACGCACACAA
GTACGCCACTT -> TACGCCACTTT
GTACTATGTTG -> TACTATGTTGT
GTAGACCAAAT -> TAGACCAAATG
GTAGACGCCCC -> TAGACGCCCCG
GTAGAGGCCAA -> TAGAGGCCAAT
GTAGAGTCGGC -> TAGAGTCGGCC
GTAGATGCACA -> TAGATGCACAA
GTAGCACGTTG -> TAGCACGTTGA
GTAGCAGCCTC -> TAGCAGCCTCA
GTAGCGGGTCC -> TAGCGGGTCCA
GTAGCTATTTC -> TAGCTATTTCC
GTAGCTGTCAA -> TAGCTGTCAAA
GTAGCTGTTAA -> TAGCTGTTAAT
GTAGGGTTTTT -> TAGGGTTTTTG
GTAGGTCCTCG -> TAGGTCCTCGG
GTAGTAAGATT -> TAGTAAGATTT
GTAGTAGCAGC -> TAGTAGCAGCC
GTAGTGAACAC -> TAGTGAACACT
GTATATGCTAC -> TATATGCTACA
GTATCCCTAGG -> TATCCCTAGGT
GTATCCGCGTT -> TATCCGCGTTC
GTATCTACTAC -> TATCTACTACT
GTATGCCTTCT -> TATGCCTTCTC
GTATGCGTGCG -> TATGCGTGCGA
GTCAAAACGTC -> TCAAAACGTCG
GTCAAACGGCG -> TCAAACGGCGA
GTCAACCCAGA -> TCAACCCAGAC
GTCACGACTCC -> TCACGACTCCG
GTCACTAGCAG -> TCACTAGCAGC
GTCCACTTCTC -> TCCACTTCTCA
GTCCAGATAAA -> TCCAGATAAAA
GTCCCTGTTGC -> TCCCTGTTGCT
GTCCCTTGCTA -> TCCCTTGCTAC
GTCCTACCCGC -> TCCTACCCGCG
GTCCTACTTAA -> TCCTACTTAAG
GTCCTAGGAAG -> TCCTAGGAAGT
GTCCTCCTAAT -> TCCTCCTAATT
GTCCTCGGTGT -> TCCTCGGTGTC
GTCCTTCCTAT -> TCCTTCCTATG
GTCGAATCACG -> TCGAATCACGA
GTCGACAAAAT -> TCGACAAAATC
GTCGACTTGCT -> TCGACTTGCTC
GTCGAGCTCTG -> TCGAGCTCTGA
GTCGATAGAAC -> TCGATAGAACA
GTCGCGGTACA -> TCGCGGTACAT
GTCGCGGTGGT -> TCGCGGTGGTG
GTCGCGTCTAC -> TCGCGTCTACA
GTCGGCCTGGC -> TCGGCCTGGCA
GTCGGGTCTAC -> TCGGGTCTACG
GTCGGGTTTTT -> TCGGGTTTTTC
GTCGGTCGCGT -> TCGGTCGCGTC
GTCGTAACTGA -> TCGTAACTGAG
GTCGTTGGTAT -> TCGTTGGTATA
GTCTACAGCTA -> TCTACAGCTAC
GTCTACGTGTC -> TCTACGTGTCT
GTCTATTGTAG -> TCTATTGTAGA
GTCTCTCAGAT -> TCTCTCAGATC
GTCTCTTCCAC -> TCTCTTCCACT
GTCTTATATGT -> TCTTATATGTA
GTCTTCTAAGA -> TCTTCTAAGAA
GTCTTGCTCGA -> TCTTGCTCGAC
GTCTTGTTGGC -> TCTTGTTGGCC
GTGAAAACGAG -> TGAAAACGAGA
GTGAACACTGC -> TGAACACTGCA
GTGAAGACAGA -> TGAAGACAGAC
GTGACCGGGGT -> TGACCGGGGTA
GTGACTTCTAG -> TGACTTCTAGC
GTGAGACTCCC -> TGAGACTCCCC
GTGAGTATGCG -> TGAGTATGCGT
GTGAGTCGGGT -> TGAGTCGGGTT
GTGATTTAAAT -> TGATTTAAATG
GTGCACAGTGT -> TGCACAGTGTC
GTGCCAGTGTC -> TGCCAGTGTCT
GTGCCCGCGAT -> TGCCCGCGATT
GTGCCCTCTCG -> TGCCCTCTCGT
GTGCGAGTGGT -> TGCGAGTGGTT
GTGCTAAGCCC -> TGCTAAGCCCT
GTGCTGCAACC -> TGCTGCAACCT
GTGGAGTAGTA -> TGGAGTAGTAA
GTGGAGTATCC -> TGGAGTATCCC
GTGGCAAGACC -> TGGCAAGACCG
GTGGCAGGCTA -> TGGCAGGCTAC
GTGGCTATAAG -> TGGCTATAAGT
GTGGCTCAACC -> TGGCTCAACCG
GTGGGCATGCC -> TGGGCATGCCC
GTGGTCGCGGT -> TGGTCGCGGTA
GTGGTGTACCA -> TGGTGTACCAA
GTGGTGTACGA -> TGGTGTACGAC
GTGGTTTTGGT -> TGGTTTTGGTG
GTGTACCAAGC -> TGTACCAAGCA
GTGTACGACAA -> TGTACGACAAG
GTGTCTATTGT -> TGTCTATTGTA
GTGTCTCTCAG -> TGTCTCTCAGA
GTGTCTCTTCC -> TGTCTCTTCCA
GTGTCTTATAT -> TGTCTTATATG
GTGTCTTCTAA -> TGTCTTCTAAG
GTGTGAAGACA -> TGTGAAGACAG
GTGTGCCCGCG -> TGTGCCCGCGA
GTGTGGAGTAG -> TGTGGAGTAGT
GTGTTGTCCTA -> TGTTGTCCTAC
GTTAACGAAGG -> TTAACGAAGGG
GTTAATATTAG -> TTAATATTAGC
GTTAATGGAGT -> TTAATGGAGTA
GTTACATTTGG -> TTACATTTGGC
GTTACGGAGTC -> TTACGGAGTCG
GTTAGGGTTCG -> TTAGGGTTCGA
GTTAGGTAGGT -> TTAGGTAGGTC
GTTATAGCTTC -> TTATAGCTTCA
GTTATGCTTAT -> TTATGCTTATC
GTTATTCTTCT -> TTATTCTTCTA
GTTCAAGTAAC -> TTCAAGTAACA
GTTCAATCAGT -> TTCAATCAGTC
GTTCAGTTCTT -> TTCAGTTCTTG
GTTCATAGTCA -> TTCATAGTCAC
GTTCCCCACCT -> TTCCCCACCTC
GTTCCTTAATT -> TTCCTTAATTT
GTTCGATACGT -> TTCGATACGTT
GTTCTGGGATC -> TTCTGGGATCA
GTTCTTGTCTT -> TTCTTGTCTTG
GTTGAAACAAG -> TTGAAACAAGA
GTTGAGCATCG -> TTGAGCATCGG
GTTGAGGGTAA -> TTGAGGGTAAA
GTTGCACTTTT -> TTGCACTTTTC
GTTGCTCAGTT -> TTGCTCAGTTT
GTTGGCCCCCC -> TTGGCCCCCCT
GTTGGGAACGG -> TTGGGAACGGG
GTTGGGCGCAA -> TTGGGCGCAAC
GTTGGGGTGGC -> TTGGGGTGGCT
GTTGGGTAGCT -> TTGGGTAGCTG
GTTGGTATATG -> TTGGTATATGC
GTTGGTTACAT -> TTGGTTACATT
GTTGTAGCTGT -> TTGTAGCTGTC
GTTGTATGCCT -> TTGTATGCCTT
GTTGTCCTACC -> TTGTCCTACCC
GTTGTCCTAGG -> TTGTCCTAGGA
GTTGTTCCCCA -> TTGTTCCCCAC
GTTGTTGGGGT -> TTGTTGGGGTG
GTTTAGCCGAC -> TTTAGCCGACA
GTTTCTAGTTG -> TTTCTAGTTGG
GTTTCTGGTAG -> TTTCTGGTAGG
GTTTTGCTTCC -> TTTTGCTTCCG
GTTTTGGTGCA -> TTTTGGTGCAC
GTTTTGTTGTT -> TTTTGTTGTTG
GTTTTTCGTTG -> TTTTTCGTTGG
GTTTTTGTTAG -> TTTTTGTTAGG
TAAAAGCACAC -> AAAAGCACACG
TAAAATAAAGA -> AAAATAAAGAG
TAAACTGTTAT -> AAACTGTTATG
TAAAGAGGGTA -> AAAGAGGGTAG
TAAAGGCACTA -> AAAGGCACTAG
TAAAGTATCTA -> AAAGTATCTAC
TAAATACCTTC -> AAATACCTTCG
TAAATCAAGTT -> AAATCAAGTTG
TAAATGTCGGT -> AAATGTCGGTC
TAAATTATCTA -> AAATTATCTAG
TAACAACAGTT -> AACAACAGTTA
TAACAACTCGG -> AACAACTCGGG
TAACATATCCA -> AACATATCCAA
TAACCGGTGTG -> AACCGGTGTGG
TAACGAAGGGT -> AACGAAGGGTC
TAACGACTCGA -> AACGACTCGAG
TAACTCCTCAC -> AACTCCTCACG
TAACTGAGGGG -> AACTGAGGGGT
TAACTGCTATC -> AACTGCTATCC
TAAGAACTTGC -> AAGAACTTGCA
TAAGATTTCGT -> AAGATTTCGTG
TAAGCCATTCG -> AAGCCATTCGC
TAAGCCCTAGT -> AAGCCCTAGTT
TAAGTGCCAGT -> AAGTGCCAGTG
TAATACATGTA -> AATACATGTAA
TAATATTAGCG -> AATATTAGCGT
TAATGGAGTAT -> AATGGAGTATC
TAATTAGCTTC -> AATTAGCTTCT
TAATTTCAGTC -> AATTTCAGTCA
TACAAAACGTG -> ACAAAACGTGC
TACAACTGAGT -> ACAACTGAGTA
TACACATCGGA -> ACACATCGGAT
TACACTACATT -> ACACTACATTT
TACAGATGAAT -> ACAGATGAATA
TACAGCTACCT -> ACAGCTACCTC
TACAGGAGTTC -> ACAGGAGTTCA
TACAGGCCGCT -> ACAGGCCGCTA
TACATGCCAGG -> ACATGCCAGGG
TACATGTAAAT -> ACATGTAAATT
TACATTAAATA -> ACATTAAATAC
TACATTTGAGC -> ACATTTGAGCG
TACATTTGGCA -> ACATTTGGCAC
TACCAAGCACC -> ACCAAGCACCG
TACCAGGATAT -> ACCAGGATATA
TACCCCACCGT -> ACCCCACCGTA
TACCCGCGGCG -> ACCCGCGGCGG
TACCGCTGTTA -> ACCGCTGTTAT
TACCGTCGGGT -> ACCGTCGGGTC
TACCTCTCCTT -> ACCTCTCCTTA
TACCTTCGGTC -> ACCTTCGGTCA
TACGACAAGAG -> ACGACAAGAGT
TACGCACACAA -> ACGCACACAAT
TACGCCACTTT -> ACGCCACTTTC
TACGCGACATA -> ACGCGACATAT
TACGGAGTCGA -> ACGGAGTCGAC
TACGTGTCTCT -> ACGTGTCTCTT
TACGTTATAGC -> ACGTTATAGCT
TACTAACTCCT -> ACTAACTCCTC
TACTACTAACT -> ACTACTAACTC
TACTATGTTGT -> ACTATGTTGTA
TACTGGCATCG -> ACTGGCATCGA
TACTTAAGCCA -> ACTTAAGCCAT
TACTTGTTGTC -> ACTTGTTGTCC
TAGAACATCCA -> AGAACATCCAA
TAGACCAAATG -> AGACCAAATGG
TAGACGCCCCG -> AGACGCCCCGA
TAGAGGCCAAT -> AGAGGCCAATT
TAGAGTCGGCC -> AGAGTCGGCCT
TAGATGCACAA -> AGATGCACAAG
TAGCACGTTGA -> AGCACGTTGAG
TAGCAGCCGAT -> AGCAGCCGATT
TAGCAGCCTCA -> AGCAGCCTCAC
TAGCCGACAGG -> AGCCGACAGGT
TAGCCGGGGGC -> AGCCGGGGGCC
TAGCGAAGGGG -> AGCGAAGGGGC
TAGCGGGTCCA -> AGCGGGTCCAG
TAGCGTGAAAA -> AGCGTGAAAAC
TAGCTATTTCC -> AGCTATTTCCA
TAGCTGTCAAA -> AGCTGTCAAAC
TAGCTGTTAAT -> AGCTGTTAATG
TAGCTTCATTG -> AGCTTCATTGT
TAGCTTCTGGT -> AGCTTCTGGTG
TAGCTTTTCAT -> AGCTTTTCATG
TAGGAAGTAGT -> AGGAAGTAGTG
TAGGAGTGTGA -> AGGAGTGTGAA
TAGGATTCTTC -> AGGATTCTTCG
TAGGGTTCGAT -> AGGGTTCGATA
TAGGGTTTTTG -> AGGGTTTTTGT
TAGGTACAACT -> AGGTACAACTG
TAGGTAGGTCC -> AGGTAGGTCCT
TAGGTCCTCGG -> AGGTCCTCGGT
TAGGTGGGCAT -> AGGTGGGCATG
TAGTAAGATTT -> AGTAAGATTTC
TAGTAGCAGCC -> AGTAGCAGCCT
TAGTCACGACT -> AGTCACGACTC
TAGTGAACACT -> AGTGAACACTG
TAGTGGCAGGC -> AGTGGCAGGCT
TAGTTGGGAAC -> AGTTGGGAACG
TAGTTGGTTAC -> AGTTGGTTACA
TAGTTTAGCCG -> AGTTTAGCCGA
TATAAGTGCCA -> ATAAGTGCCAG
TATACCAGGAT -> ATACCAGGATA
TATAGCTTCAT -> ATAGCTTCATT
TATATGCGCCG -> ATATGCGCCGT
TATATGCTACA -> ATATGCTACAC
TATATGTACGC -> ATATGTACGCA
TATCATAGTGG -> ATCATAGTGGC
TATCCAACGTA -> ATCCAACGTAA
TATCCCTAGGT -> ATCCCTAGGTG
TATCCGCGTTC -> ATCCGCGTTCA
TATCCGTGTCT -> ATCCGTGTCTT
TATCCGTTGTA -> ATCCGTTGTAT
TATCGTCGATA -> ATCGTCGATAG
TATCTACTACT -> ATCTACTACTA
TATCTAGTTTA -> ATCTAGTTTAG
TATGATAAAGG -> ATGATAAAGGC
TATGCCTTCTC -> ATGCCTTCTCA
TATGCGCCGTG -> ATGCGCCGTGG
TATGCGGCCGT -> ATGCGGCCGTA
TATGCGTGCGA -> ATGCGTGCGAG
TATGCTACACT -> ATGCTACACTA
TATGCTTATCC -> ATGCTTATCCG
TATGGTGCCCT -> ATGGTGCCCTC
TATGTACGCAC -> ATGTACGCACA
TATGTTGTAGC -> ATGTTGTAGCT
TATTAGCGTGA -> ATTAGCGTGAA
TATTCGGCAGT -> ATTCGGCAGTG
TATTCTTCTAG -> ATTCTTCTAGG
TATTGTAGAGT -> ATTGTAGAGTC
TATTTCCATGT -> ATTTCCATGTA
TCAAAACGTCG -> CAAAACGTCGA
TCAAACGGCGA -> CAAACGGCGAT
TCAACCCAGAC -> CAACCCAGACG
TCAACCGCCGG -> CAACCGCCGGT
TCAAGTAACAA -> CAAGTAACAAC
TCAAGTTGAAA -> CAAGTTGAAAC
TCAATCAGTCC -> CAATCAGTCCT
TCACAAGCCTG -> CACAAGCCTGA
TCACCGTTGGG -> CACCGTTGGGC
TCACCTCCACG -> CACCTCCACGC
TCACGACATCG -> CACGACATCGC
TCACGACTCCG -> CACGACTCCGC
TCACGTTAGGT -> CACGTTAGGTA
TCACTAGCAGC -> CACTAGCAGCC
TCACTTTTCTT -> CACTTTTCTTA
TCAGATCCACG -> CAGATCCACGC
TCAGGGGTTTT -> CAGGGGTTTTG
TCAGTCACTAG -> CAGTCACTAGC
TCAGTCCTACT -> CAGTCCTACTT
TCAGTCGCGGT -> CAGTCGCGGTG
TCAGTTCTTGT -> CAGTTCTTGTC
TCAGTTTCTGG -> CAGTTTCTGGT
TCATAGTCACG -> CATAGTCACGA
TCATAGTGGCA -> CATAGTGGCAG
TCATGAGGTAC -> CATGAGGTACC
TCATGCTTCCC -> CATGCTTCCCA
TCATGTCCTTC -> CATGTCCTTCC
TCATTGTCCTC -> CATTGTCCTCC
TCCAAAACCCC -> CCAAAACCCCC
TCCAAACACGT -> CCAAACACGTG
TCCAACGTAAC -> CCAACGTAACT
TCCAACTGTAG -> CCAACTGTAGC
TCCAAGTTCCT -> CCAAGTTCCTT
TCCACGCCAGA -> CCACGCCAGAG
TCCACGCCCCG -> CCACGCCCCGC
TCCACTTAACA -> CCACTTAACAT
TCCACTTCTCA -> CCACTTCTCAG
TCCAGATAAAA -> CCAGATAAAAT
TCCATGTAAAG -> CCATGTAAAGT
TCCCACCACTA -> CCCACCACTAC
TCCCCACCTCA -> CCCCACCTCAC
TCCCCCACATT -> CCCCCACATTT
TCCCTAGGTGG -> CCCTAGGTGGG
TCCCTGTTGCT -> CCCTGTTGCTC
TCCCTTGCTAC -> CCCTTGCTACA
TCCGCGCGCGA -> CCGCGCGCGAT
TCCGCGTTCAT -> CCGCGTTCATA
TCCGGTCAAAA -> CCGGTCAAAAC
TCCGTGTCTTC -> CCGTGTCTTCT
TCCGTTGTATG -> CCGTTGTATGC
TCCTAATTAGC -> CCTAATTAGCT
TCCTACCCGCG -> CCTACCCGCGG
TCCTACTTAAG -> CCTACTTAAGC
TCCTAGGAAGT -> CCTAGGAAGTA
TCCTATGGTGC -> CCTATGGTGCC
TCCTCACGTTA -> CCTCACGTTAG
TCCTCCTAATT -> CCTCCTAATTA
TCCTCGGTGTC -> CCTCGGTGTCT
TCCTTAATTTC -> CCTTAATTTCA
TCCTTAGGAGT -> CCTTAGGAGTG
TCCTTCCTATG -> CCTTCCTATGG
TCGAATAAACT -> CGAATAAACTG
TCGAATCACGA -> CGAATCACGAC
TCGACAAAATC -> CGACAAAATCG
TCGACGACGCT -> CGACGACGCTG
TCGACTGTAGA -> CGACTGTAGAT
TCGACTTGCTC -> CGACTTGCTCT
TCGAGCTCTGA -> CGAGCTCTGAT
TCGAGTCTTGC -> CGAGTCTTGCT
TCGATACGTTA -> CGATACGTTAT
TCGATAGAACA -> CGATAGAACAT
TCGCACTGAGT -> CGCACTGAGTT
TCGCGGTACAT -> CGCGGTACATT
TCGCGGTGGTG -> CGCGGTGGTGT
TCGCGTAGTAG -> CGCGTAGTAGC
TCGCGTCTACA -> CGCGTCTACAG
TCGCTTCATGC -> CGCTTCATGCT
TCGGATTGCCT -> CGGATTGCCTG
TCGGCAGTGGC -> CGGCAGTGGCT
TCGGCCTGGCA -> CGGCCTGGCAG
TCGGGGGGGAA -> CGGGGGGGAAC
TCGGGTCTACG -> CGGGTCTACGT
TCGGGTTTTTC -> CGGGTTTTTCG
TCGGTCAACCC -> CGGTCAACCCA
TCGGTCGCGTC -> CGGTCGCGTCT
TCGGTGTCTCT -> CGGTGTCTCTC
TCGGTTTCTAG -> CGGTTTCTAGT
TCGGTTTTGTT -> CGGTTTTGTTG
TCGTAACTGAG -> CGTAACTGAGG
TCGTACAGGCC -> CGTACAGGCCG
TCGTCCCTGTT -> CGTCCCTGTTG
TCGTCCCTTGC -> CGTCCCTTGCT
TCGTCGATAGA -> CGTCGATAGAA
TCGTGACTTCT -> CGTGACTTCTA
TCGTTGGGTAG -> CGTTGGGTAGC
TCGTTGGTATA -> CGTTGGTATAT
TCTAAGAACTT -> CTAAGAACTTG
TCTACAGCTAC -> CTACAGCTACC
TCTACCGTCGG -> CTACCGTCGGG
TCTACGTGTCT -> CTACGTGTCTC
TCTACTACTAA -> CTACTACTAAC
TCTAGCGAAGG -> CTAGCGAAGGG
TCTAGGATTCT -> CTAGGATTCTT
TCTAGTTGGGA -> CTAGTTGGGAA
TCTAGTTTAGC -> CTAGTTTAGCC
TCTATTGTAGA -> CTATTGTAGAG
TCTCACCGTTG -> CTCACCGTTGG
TCTCAGATCCA -> CTCAGATCCAC
TCTCAGGGGTT -> CTCAGGGGTTT
TCTCCTTAGGA -> CTCCTTAGGAG
TCTCGTACAGG -> CTCGTACAGGC
TCTCTAGTCTG -> CTCTAGTCTGC
TCTCTCAGATC -> CTCTCAGATCC
TCTCTTCCACT -> CTCTTCCACTT
TCTGATAACAA -> CTGATAACAAC
TCTGGGATCAG -> CTGGGATCAGT
TCTGGTAGGGT -> CTGGTAGGGTT
TCTGGTGACCG -> CTGGTGACCGG
TCTTACTTGTT -> CTTACTTGTTG
TCTTATATGTA -> CTTATATGTAC
TCTTCCACTTA -> CTTCCACTTAA
TCTTCGACTGT -> CTTCGACTGTA
TCTTCTAAGAA -> CTTCTAAGAAC
TCTTCTAGGAT -> CTTCTAGGATT
TCTTGCATCGT -> CTTGCATCGTC
TCTTGCTCGAC -> CTTGCTCGACG
TCTTGTCTTGT -> CTTGTCTTGTT
TCTTGTTGGCC -> CTTGTTGGCCC
TGAAAACGAGA -> GAAAACGAGAT
TGAAACAAGAC -> GAAACAAGACA
TGAACACTGCA -> GAACACTGCAC
TGAAGACAGAC -> GAAGACAGACC
TGAAGAGAGGA -> GAAGAGAGGAC
TGAATATCATA -> GAATATCATAG
TGAATGCGAAT -> GAATGCGAATT
TGACATAGGTA -> GACATAGGTAC
TGACCGGGGTA -> GACCGGGGTAC
TGACTTCTAGC -> GACTTCTAGCG
TGAGACTCCCC -> GAGACTCCCCC
TGAGCAGGTCC -> GAGCAGGTCCA
TGAGCATCGGT -> GAGCATCGGTT
TGAGCGAACGC -> GAGCGAACGCT
TGAGGGGTGGT -> GAGGGGTGGTC
TGAGGGTAAAT -> GAGGGTAAATC
TGAGGTACCGC -> GAGGTACCGCT
TGAGTACAAAA -> GAGTACAAAAC
TGAGTATGCGT -> GAGTATGCGTG
TGAGTCGGGTT -> GAGTCGGGTTT
TGAGTTGAGCA -> GAGTTGAGCAT
TGATAAAGGCA -> GATAAAGGCAC
TGATAACAACA -> GATAACAACAG
TGATGAATGCG -> GATGAATGCGA
TGATTTAAATG -> GATTTAAATGT
TGCAACCTTTT -> GCAACCTTTTC
TGCAAGACCCG -> GCAAGACCCGG
TGCACAAGGGA -> GCACAAGGGAG
TGCACAGTGTC -> GCACAGTGTCT
TGCACGACTCA -> GCACGACTCAT
TGCACTTTTCG -> GCACTTTTCGG
TGCATCGTCCC -> GCATCGTCCCT
TGCCAGGGGGA -> GCCAGGGGGAG
TGCCAGTGTCT -> GCCAGTGTCTA
TGCCCGCGATT -> GCCCGCGATTG
TGCCCTCTCGT -> GCCCTCTCGTA
TGCCCTTTTGC -> GCCCTTTTGCT
TGCCTGTAGAG -> GCCTGTAGAGG
TGCCTTCTCAC -> GCCTTCTCACC
TGCGAATTACA -> GCGAATTACAG
TGCGAGTGGTT -> GCGAGTGGTTT
TGCGCCGTGGA -> GCGCCGTGGAG
TGCGGCCGTAG -> GCGGCCGTAGA
TGCGTGCGAGT -> GCGTGCGAGTG
TGCTAAGCCCT -> GCTAAGCCCTA
TGCTACACTAC -> GCTACACTACA
TGCTACATGCC -> GCTACATGCCA
TGCTATCCGTT -> GCTATCCGTTG
TGCTCAGTTTC -> GCTCAGTTTCT
TGCTCGACGAC -> GCTCGACGACG
TGCTCTCTAGT -> GCTCTCTAGTC
TGCTGACATAG -> GCTGACATAGG
TGCTGCAACCT -> GCTGCAACCTT
TGCTTATCCGT -> GCTTATCCGTG
TGCTTCCCACC -> GCTTCCCACCA
TGCTTCCGGTC -> GCTTCCGGTCA
TGGAGTAGTAA -> GGAGTAGTAAG
TGGAGTATCCC -> GGAGTATCCCT
TGGAGTATCCG -> GGAGTATCCGC
TGGCAAGACCG -> GGCAAGACCGC
TGGCACTAATA -> GGCACTAATAC
TGGCAGGCTAC -> GGCAGGCTACT
TGGCAGTGCTA -> GGCAGTGCTAA
TGGCATCGAAT -> GGCATCGAATA
TGGCCCCCCTC -> GGCCCCCCTCC
TGGCCGTTAAC -> GGCCGTTAACG
TGGCTATAAGT -> GGCTATAAGTG
TGGCTCAACCG -> GGCTCAACCGC
TGGGAACGGGC -> GGGAACGGGCG
TGGGATCAGTC -> GGGATCAGTCG
TGGGATTAAAA -> GGGATTAAAAG
TGGGCATGCCC -> GGGCATGCCCT
TGGGCGCAACG -> GGGCGCAACGC
TGGGGTGGCTA -> GGGGTGGCTAT
TGGGTACGCCA -> GGGTACGCCAC
TGGGTAGCTGT -> GGGTAGCTGTT
TGGGTGATTTA -> GGGTGATTTAA
TGGTAGGGTTT -> GGTAGGGTTTT
TGGTATATGCT -> GGTATATGCTA
TGGTCGCGGTA -> GGTCGCGGTAC
TGGTGACCGGG -> GGTGACCGGGG
TGGTGCACAGT -> GGTGCACAGTG
TGGTGCCCTCT -> GGTGCCCTCTC
TGGTGTACCAA -> GGTGTACCAAG
TGGTGTACGAC -> GGTGTACGACA
TGGTTACATTT -> GGTTACATTTG
TGGTTTTGGTG -> GGTTTTGGTGC
TGTAAAGTATC -> GTAAAGTATCT
TGTAAATTATC -> GTAAATTATCT
TGTAACCGGTG -> GTAACCGGTGT
TGTACCAAGCA -> GTACCAAGCAC
TGTACGACAAG -> GTACGACAAGA
TGTACGCACAC -> GTACGCACACA
TGTAGAGGCCA -> GTAGAGGCCAA
TGTAGAGTCGG -> GTAGAGTCGGC
TGTAGATGCAC -> GTAGATGCACA
TGTAGCACGTT -> GTAGCACGTTG
TGTAGCTGTCA -> GTAGCTGTCAA
TGTATGCCTTC -> GTATGCCTTCT
TGTCAAACGGC -> GTCAAACGGCG
TGTCCTACCCG -> GTCCTACCCGC
TGTCCTAGGAA -> GTCCTAGGAAG
TGTCCTCCTAA -> GTCCTCCTAAT
TGTCCTTCCTA -> GTCCTTCCTAT
TGTCGGTCGCG -> GTCGGTCGCGT
TGTCTATTGTA -> GTCTATTGTAG
TGTCTCTCAGA -> GTCTCTCAGAT
TGTCTCTTCCA -> GTCTCTTCCAC
TGTCTTATATG -> GTCTTATATGT
TGTCTTCTAAG -> GTCTTCTAAGA
TGTCTTGTTGG -> GTCTTGTTGGC
TGTGAAGACAG -> GTGAAGACAGA
TGTGCCCGCGA -> GTGCCCGCGAT
TGTGGAGTAGT -> GTGGAGTAGTA
TGTTAATGGAG -> GTTAATGGAGT
TGTTAGGGTTC -> GTTAGGGTTCG
TGTTATGCTTA -> GTTATGCTTAT
TGTTATTCTTC -> GTTATTCTTCT
TGTTCAGTTCT -> GTTCAGTTCTT
TGTTCCCCACC -> GTTCCCCACCT
TGTTCTGGGAT -> GTTCTGGGATC
TGTTGCTCAGT -> GTTGCTCAGTT
TGTTGGCCCCC -> GTTGGCCCCCC
TGTTGGGGTGG -> GTTGGGGTGGC
TGTTGTAGCTG -> GTTGTAGCTGT
TGTTGTCCTAC -> GTTGTCCTACC
TGTTGTCCTAG -> GTTGTCCTAGG
TGTTGTTCCCC -> GTTGTTCCCCA
TGTTGTTGGGG -> GTTGTTGGGGT
TTAAAAGCACA -> TAAAAGCACAC
TTAAATACCTT -> TAAATACCTTC
TTAAATGTCGG -> TAAATGTCGGT
TTAACATATCC -> TAACATATCCA
TTAACGAAGGG -> TAACGAAGGGT
TTAAGCCATTC -> TAAGCCATTCG
TTAATATTAGC -> TAATATTAGCG
TTAATGGAGTA -> TAATGGAGTAT
TTAATTTCAGT -> TAATTTCAGTC
TTACAGATGAA -> TACAGATGAAT
TTACAGGAGTT -> TACAGGAGTTC
TTACATTTGGC -> TACATTTGGCA
TTACGCGACAT -> TACGCGACATA
TTACGGAGTCG -> TACGGAGTCGA
TTACTTGTTGT -> TACTTGTTGTC
TTAGCCGACAG -> TAGCCGACAGG
TTAGCGTGAAA -> TAGCGTGAAAA
TTAGCTTCTGG -> TAGCTTCTGGT
TTAGGAGTGTG -> TAGGAGTGTGA
TTAGGGTTCGA -> TAGGGTTCGAT
TTAGGTAGGTC -> TAGGTAGGTCC
TTATACCAGGA -> TATACCAGGAT
TTATAGCTTCA -> TATAGCTTCAT
TTATATGTACG -> TATATGTACGC
TTATCCGTGTC -> TATCCGTGTCT
TTATCTAGTTT -> TATCTAGTTTA
TTATGATAAAG -> TATGATAAAGG
TTATGCTTATC -> TATGCTTATCC
TTATTCTTCTA -> TATTCTTCTAG
TTCAAGTAACA -> TCAAGTAACAA
TTCAATCAGTC -> TCAATCAGTCC
TTCACAAGCCT -> TCACAAGCCTG
TTCAGTCACTA -> TCAGTCACTAG
TTCAGTTCTTG -> TCAGTTCTTGT
TTCATAGTCAC -> TCATAGTCACG
TTCATGAGGTA -> TCATGAGGTAC
TTCATGCTTCC -> TCATGCTTCCC
TTCATTGTCCT -> TCATTGTCCTC
TTCCAAACACG -> TCCAAACACGT
TTCCAACTGTA -> TCCAACTGTAG
TTCCACTTAAC -> TCCACTTAACA
TTCCATGTAAA -> TCCATGTAAAG
TTCCCACCACT -> TCCCACCACTA
TTCCCCACCTC -> TCCCCACCTCA
TTCCGGTCAAA -> TCCGGTCAAAA
TTCCTATGGTG -> TCCTATGGTGC
TTCCTTAATTT -> TCCTTAATTTC
TTCGACTGTAG -> TCGACTGTAGA
TTCGATACGTT -> TCGATACGTTA
TTCGCTTCATG -> TCGCTTCATGC
TTCGGCAGTGG -> TCGGCAGTGGC
TTCGGTCAACC -> TCGGTCAACCC
TTCGGTTTTGT -> TCGGTTTTGTT
TTCGTCCCTTG -> TCGTCCCTTGC
TTCGTGACTTC -> TCGTGACTTCT
TTCGTTGGGTA -> TCGTTGGGTAG
TTCTAAGAACT -> TCTAAGAACTT
TTCTACCGTCG -> TCTACCGTCGG
TTCTAGCGAAG -> TCTAGCGAAGG
TTCTAGGATTC -> TCTAGGATTCT
TTCTAGTTGGG -> TCTAGTTGGGA
TTCTCACCGTT -> TCTCACCGTTG
TTCTCAGGGGT -> TCTCAGGGGTT
TTCTGGGATCA -> TCTGGGATCAG
TTCTGGTAGGG -> TCTGGTAGGGT
TTCTGGTGACC -> TCTGGTGACCG
TTCTTACTTGT -> TCTTACTTGTT
TTCTTCGACTG -> TCTTCGACTGT
TTCTTCTAGGA -> TCTTCTAGGAT
TTCTTGCATCG -> TCTTGCATCGT
TTCTTGTCTTG -> TCTTGTCTTGT
TTGAAACAAGA -> TGAAACAAGAC
TTGAGCATCGG -> TGAGCATCGGT
TTGAGCGAACG -> TGAGCGAACGC
TTGAGGGTAAA -> TGAGGGTAAAT
TTGCAAGACCC -> TGCAAGACCCG
TTGCACTTTTC -> TGCACTTTTCG
TTGCATCGTCC -> TGCATCGTCCC
TTGCCTGTAGA -> TGCCTGTAGAG
TTGCTACATGC -> TGCTACATGCC
TTGCTCAGTTT -> TGCTCAGTTTC
TTGCTCGACGA -> TGCTCGACGAC
TTGCTCTCTAG -> TGCTCTCTAGT
TTGCTGACATA -> TGCTGACATAG
TTGCTTCCGGT -> TGCTTCCGGTC
TTGGCACTAAT -> TGGCACTAATA
TTGGCCCCCCT -> TGGCCCCCCTC
TTGGGAACGGG -> TGGGAACGGGC
TTGGGATTAAA -> TGGGATTAAAA
TTGGGCGCAAC -> TGGGCGCAACG
TTGGGGTGGCT -> TGGGGTGGCTA
TTGGGTACGCC -> TGGGTACGCCA
TTGGGTAGCTG -> TGGGTAGCTGT
TTGGTATATGC -> TGGTATATGCT
TTGGTGCACAG -> TGGTGCACAGT
TTGGTTACATT -> TGGTTACATTT
TTGTAGAGTCG -> TGTAGAGTCGG
TTGTAGCTGTC -> TGTAGCTGTCA
TTGTATGCCTT -> TGTATGCCTTC
TTGTCCTACCC -> TGTCCTACCCG
TTGTCCTAGGA -> TGTCCTAGGAA
TTGTCCTCCTA -> TGTCCTCCTAA
TTGTCTTGTTG -> TGTCTTGTTGG
TTGTTAGGGTT -> TGTTAGGGTTC
TTGTTCCCCAC -> TGTTCCCCACC
TTGTTGGCCCC -> TGTTGGCCCCC
TTGTTGGGGTG -> TGTTGGGGTGG
TTGTTGTCCTA -> TGTTGTCCTAG
TTGTTGTTGGG -> TGTTGTTGGGG
TTTAAATGTCG -> TTAAATGTCGG
TTTACAGGAGT -> TTACAGGAGTT
TTTAGCCGACA -> TTAGCCGACAG
TTTCACAAGCC -> TTCACAAGCCT
TTTCAGTCACT -> TTCAGTCACTA
TTTCATGAGGT -> TTCATGAGGTA
TTTCCATGTAA -> TTCCATGTAAA
TTTCGGTTTTG -> TTCGGTTTTGT
TTTCGTCCCTT -> TTCGTCCCTTG
TTTCGTGACTT -> TTCGTGACTTC
TTTCGTTGGGT -> TTCGTTGGGTA
TTTCTACCGTC -> TTCTACCGTCG
TTTCTAGTTGG -> TTCTAGTTGGG
TTTCTGGTAGG -> TTCTGGTAGGG
TTTCTTACTTG -> TTCTTACTTGT
TTTGAGCGAAC -> TTGAGCGAACG
TTTGCTGACAT -> TTGCTGACATA
TTTGCTTCCGG -> TTGCTTCCGGT
TTTGGCACTAA -> TTGGCACTAAT
TTTGGTGCACA -> TTGGTGCACAG
TTTGTTAGGGT -> TTGTTAGGGTT
TTTGTTGTTGG -> TTGTTGTTGGG
TTTTCATGAGG -> TTTCATGAGGT
TTTTCGGTTTT -> TTTCGGTTTTG
TTTTCGTTGGG -> TTTCGTTGGGT
TTTTCTACCGT -> TTTCTACCGTC
TTTTCTTACTT -> TTTCTTACTTG
TTTTGCTGACA -> TTTGCTGACAT
TTTTGCTTCCG -> TTTGCTTCCGG
TTTTGGTGCAC -> TTTGGTGCACA
TTTTGTTAGGG -> TTTGTTAGGGT
TTTTGTTGTTG -> TTTGTTGTTGG
TTTTTCGTTGG -> TTTTCGTTGGG
TTTTTGTTAGG -> TTTTGTTAGGG
